competition, pl_team, pl_pi, pl_w, pl_d, pl_l, pl_f, pl_a, pl_gd, pl_pts
African Nations - Group A 2008,Ghana *,3,3,0,0,5,1,4,9
African Nations - Group A 2008,Guinea *,3,1,1,1,5,5,0,4
African Nations - Group A 2008,Morocco *,3,1,0,2,7,6,1,3
African Nations - Group A 2008,Namibia *,3,0,1,2,2,7,-5,1
African Nations - Group B 2008,Ivory Coast *,3,3,0,0,8,1,7,9
African Nations - Group B 2008,Nigeria *,3,1,1,1,2,1,1,4
African Nations - Group B 2008,Mali *,3,1,1,1,1,3,-2,4
African Nations - Group B 2008,Benin *,3,0,0,3,1,7,-6,0
African Nations - Group C 2008,Egypt *,3,2,1,0,8,3,5,7
African Nations - Group C 2008,Cameroon *,3,2,0,1,10,5,5,6
African Nations - Group C 2008,Zambia *,3,1,1,1,5,6,-1,4
African Nations - Group C 2008,Sudan *,3,0,0,3,0,9,-9,0
African Nations - Group D 2008,Tunisia *,3,1,2,0,5,3,2,5
African Nations - Group D 2008,Angola *,3,1,2,0,4,2,2,5
African Nations - Group D 2008,Senegal *,3,0,2,1,4,6,-2,2
African Nations - Group D 2008,South Africa *,3,0,2,1,3,5,-2,2
Africa Cup of Nations - Group A 2010,Angola,3,1,2,0,6,4,2,5
Africa Cup of Nations - Group A 2010,Mali,3,1,1,1,7,6,1,4
Africa Cup of Nations - Group A 2010,Algeria,3,1,1,1,1,3,-2,4
Africa Cup of Nations - Group A 2010,Malawi,3,1,0,2,4,5,-1,3
Africa Cup of Nations - Group C 2010,Egypt,3,3,0,0,7,1,6,9
Africa Cup of Nations - Group C 2010,Nigeria,3,2,0,1,5,3,2,6
Africa Cup of Nations - Group C 2010,Benin,3,0,1,2,2,5,-3,1
Africa Cup of Nations - Group C 2010,Mozambique,3,0,1,2,2,7,-5,1
Africa Cup of Nations - Group D 2010,Zambia,3,1,1,1,5,5,0,4
Africa Cup of Nations - Group D 2010,Cameroon,3,1,1,1,5,5,0,4
Africa Cup of Nations - Group D 2010,Gabon,3,1,1,1,2,2,0,4
Africa Cup of Nations - Group D 2010,Tunisia,3,0,3,0,3,3,0,3
Africa Cup of Nations - Group A 2012,Zambia,3,2,1,0,5,3,2,7
Africa Cup of Nations - Group A 2012,Equatorial Guinea,3,2,0,1,3,2,1,6
Africa Cup of Nations - Group A 2012,Libya,3,1,1,1,4,4,0,4
Africa Cup of Nations - Group A 2012,Senegal,3,0,0,3,3,6,-3,0
Africa Cup of Nations - Group B 2012,Ivory Coast,3,3,0,0,5,0,5,9
Africa Cup of Nations - Group B 2012,Sudan,3,1,1,1,4,4,0,4
Africa Cup of Nations - Group B 2012,Angola,3,1,1,1,4,5,-1,4
Africa Cup of Nations - Group B 2012,Burkina,3,0,0,3,2,6,-4,0
Africa Cup of Nations - Group C 2012,Gabon,3,3,0,0,6,2,4,9
Africa Cup of Nations - Group C 2012,Tunisia,3,2,0,1,4,3,1,6
Africa Cup of Nations - Group C 2012,Morocco,3,1,0,2,4,5,-1,3
Africa Cup of Nations - Group C 2012,Niger,3,0,0,3,1,5,-4,0
Africa Cup of Nations - Group D 2012,Ghana,3,2,1,0,4,1,3,7
Africa Cup of Nations - Group D 2012,Mali,3,2,0,1,3,3,0,6
Africa Cup of Nations - Group D 2012,Guinea,3,1,1,1,7,3,4,4
Africa Cup of Nations - Group D 2012,Botswana,3,0,0,3,2,9,-7,0
Africa Cup of Nations - Group B 2013,Ghana,3,2,1,0,6,2,4,7
Africa Cup of Nations - Group B 2013,Mali,3,1,1,1,2,2,0,4
Africa Cup of Nations - Group B 2013,DR Congo,3,0,3,0,3,3,0,3
Africa Cup of Nations - Group B 2013,Niger,3,0,1,2,0,4,-4,1
Africa Cup of Nations - Group C 2013,Burkina,3,1,2,0,5,1,4,5
Africa Cup of Nations - Group C 2013,Nigeria,3,1,2,0,4,2,2,5
Africa Cup of Nations - Group C 2013,Zambia,3,0,3,0,2,2,0,3
Africa Cup of Nations - Group C 2013,Ethiopia,3,0,1,2,1,7,-6,1
Africa Cup of Nations - Group D 2013,Ivory Coast,3,2,1,0,7,3,4,7
Africa Cup of Nations - Group D 2013,Togo,3,1,1,1,4,3,1,4
Africa Cup of Nations - Group D 2013,Tunisia,3,1,1,1,2,4,-2,4
Africa Cup of Nations - Group D 2013,Algeria,3,0,1,2,2,5,-3,1
Africa Cup of Nations - Group A 2015,Congo,3,2,1,0,4,2,2,7
Africa Cup of Nations - Group A 2015,Equatorial Guinea,3,1,2,0,3,1,2,5
Africa Cup of Nations - Group A 2015,Gabon,3,1,0,2,2,3,-1,3
Africa Cup of Nations - Group A 2015,Burkina,3,0,1,2,1,4,-3,1
Africa Cup of Nations - Group B 2015,Tunisia,3,1,2,0,4,3,1,5
Africa Cup of Nations - Group B 2015,DR Congo,3,0,3,0,2,2,0,3
Africa Cup of Nations - Group B 2015,Cape Verde,3,0,3,0,1,1,0,3
Africa Cup of Nations - Group B 2015,Zambia,3,0,2,1,2,3,-1,2
Africa Cup of Nations - Group C 2015,Ghana,3,2,0,1,4,3,1,6
Africa Cup of Nations - Group C 2015,Algeria,3,2,0,1,5,2,3,6
Africa Cup of Nations - Group C 2015,Senegal,3,1,1,1,3,4,-1,4
Africa Cup of Nations - Group C 2015,South Africa,3,0,1,2,3,6,-3,1
Africa Cup of Nations - Group D 2015,Ivory Coast,3,1,2,0,3,2,1,5
Africa Cup of Nations - Group D 2015,Guinea,3,0,3,0,3,3,0,3
Africa Cup of Nations - Group D 2015,Mali,3,0,3,0,3,3,0,3
Africa Cup of Nations - Group D 2015,Cameroon,3,0,2,1,2,3,-1,2
Africa Cup of Nations - Group A 2017,Burkina,3,1,2,0,4,2,2,5
Africa Cup of Nations - Group A 2017,Cameroon,3,1,2,0,3,2,1,5
Africa Cup of Nations - Group A 2017,Gabon,3,0,3,0,2,2,0,3
Africa Cup of Nations - Group A 2017,Guinea-Bissau,3,0,1,2,2,5,-3,1
Africa Cup of Nations - Group B 2017,Senegal,3,2,1,0,6,2,4,7
Africa Cup of Nations - Group B 2017,Tunisia,3,2,0,1,6,5,1,6
Africa Cup of Nations - Group B 2017,Algeria,3,0,2,1,5,6,-1,2
Africa Cup of Nations - Group B 2017,Zimbabwe,3,0,1,2,4,8,-4,1
Africa Cup of Nations - Group C 2017,DR Congo,3,2,1,0,6,3,3,7
Africa Cup of Nations - Group C 2017,Morocco,3,2,0,1,4,2,2,6
Africa Cup of Nations - Group C 2017,Ivory Coast,3,0,2,1,2,3,-1,2
Africa Cup of Nations - Group C 2017,Togo,3,0,1,2,2,6,-4,1
Africa Cup of Nations - Group D 2017,Egypt,3,2,1,0,2,0,2,7
Africa Cup of Nations - Group D 2017,Ghana,3,2,0,1,2,1,1,6
Africa Cup of Nations - Group D 2017,Mali,3,0,2,1,1,2,-1,2
Africa Cup of Nations - Group D 2017,Uganda,3,0,1,2,1,3,-2,1
German Bundesliga 2009/10,Bayern Munich,34,20,10,4,72,31,41,70
German Bundesliga 2009/10,Schalke,34,19,8,7,53,31,22,65
German Bundesliga 2009/10,Werder Bremen,34,17,10,7,71,40,31,61
German Bundesliga 2009/10,Bayer Leverkusen,34,15,14,5,65,38,27,59
German Bundesliga 2009/10,Borussia Dortmund,34,16,9,9,54,42,12,57
German Bundesliga 2009/10,Stuttgart,34,15,10,9,51,41,10,55
German Bundesliga 2009/10,Hamburg,34,13,13,8,56,41,15,52
German Bundesliga 2009/10,Wolfsburg,34,14,8,12,64,58,6,50
German Bundesliga 2009/10,Mainz,34,12,11,11,36,42,-6,47
German Bundesliga 2009/10,Eintracht Frankfurt,34,12,10,12,47,54,-7,46
German Bundesliga 2009/10,Hoffenheim,34,11,9,14,44,42,2,42
German Bundesliga 2009/10,M'gladbach,34,10,9,15,43,60,-17,39
German Bundesliga 2009/10,Cologne,34,9,11,14,33,42,-9,38
German Bundesliga 2009/10,SC Freiburg,34,9,8,17,35,59,-24,35
German Bundesliga 2009/10,Hannover 96,34,9,6,19,43,67,-24,33
German Bundesliga 2009/10,FC Nurnberg,34,8,7,19,32,58,-26,31
German Bundesliga 2009/10,Bochum,34,6,10,18,33,64,-31,28
German Bundesliga 2009/10,Hertha Berlin,34,5,9,20,34,56,-22,24
German Bundesliga 2010/11,Borussia Dortmund,34,23,6,5,67,22,45,75
German Bundesliga 2010/11,Bayer Leverkusen,34,20,8,6,64,44,20,68
German Bundesliga 2010/11,Bayern Munich,34,19,8,7,81,40,41,65
German Bundesliga 2010/11,Hannover 96,34,19,3,12,49,45,4,60
German Bundesliga 2010/11,Mainz,34,18,4,12,52,39,13,58
German Bundesliga 2010/11,FC Nurnberg,34,13,8,13,47,45,2,47
German Bundesliga 2010/11,Kaiserslautern,34,13,7,14,48,51,-3,46
German Bundesliga 2010/11,Hamburg,34,12,9,13,46,52,-6,45
German Bundesliga 2010/11,SC Freiburg,34,13,5,16,41,50,-9,44
German Bundesliga 2010/11,Cologne,34,13,5,16,47,62,-15,44
German Bundesliga 2010/11,Hoffenheim,34,11,10,13,50,50,0,43
German Bundesliga 2010/11,Stuttgart,34,12,6,16,60,59,1,42
German Bundesliga 2010/11,Werder Bremen,34,10,11,13,47,61,-14,41
German Bundesliga 2010/11,Schalke,34,11,7,16,38,44,-6,40
German Bundesliga 2010/11,Wolfsburg,34,9,11,14,43,48,-5,38
German Bundesliga 2010/11,M'gladbach,34,10,6,18,48,65,-17,36
German Bundesliga 2010/11,Eintracht Frankfurt,34,9,7,18,31,49,-18,34
German Bundesliga 2010/11,St Pauli,34,8,5,21,35,68,-33,29
German Bundesliga 2011/12,Borussia Dortmund,34,25,6,3,80,25,55,81
German Bundesliga 2011/12,Bayern Munich,34,23,4,7,77,22,55,73
German Bundesliga 2011/12,Schalke,34,20,4,10,74,44,30,64
German Bundesliga 2011/12,M'gladbach,34,17,9,8,49,24,25,60
German Bundesliga 2011/12,Bayer Leverkusen,34,15,9,10,52,44,8,54
German Bundesliga 2011/12,Stuttgart,34,15,8,11,63,46,17,53
German Bundesliga 2011/12,Hannover 96,34,12,12,10,41,45,-4,48
German Bundesliga 2011/12,Wolfsburg,34,13,5,16,47,60,-13,44
German Bundesliga 2011/12,Werder Bremen,34,11,9,14,49,58,-9,42
German Bundesliga 2011/12,FC Nurnberg,34,12,6,16,38,49,-11,42
German Bundesliga 2011/12,Hoffenheim,34,10,11,13,41,47,-6,41
German Bundesliga 2011/12,SC Freiburg,34,10,10,14,45,61,-16,40
German Bundesliga 2011/12,Mainz,34,9,12,13,47,51,-4,39
German Bundesliga 2011/12,FC Augsburg,34,8,14,12,36,49,-13,38
German Bundesliga 2011/12,Hamburg,34,8,12,14,35,57,-22,36
German Bundesliga 2011/12,Hertha Berlin,34,7,10,17,38,64,-26,31
German Bundesliga 2011/12,Cologne,34,8,6,20,39,75,-36,30
German Bundesliga 2011/12,Kaiserslautern,34,4,11,19,24,54,-30,23
German Bundesliga 2012/13,Bayern Munich,34,29,4,1,98,18,80,91
German Bundesliga 2012/13,Borussia Dortmund,34,19,9,6,81,42,39,66
German Bundesliga 2012/13,Bayer Leverkusen,34,19,8,7,65,39,26,65
German Bundesliga 2012/13,Schalke,34,16,7,11,58,50,8,55
German Bundesliga 2012/13,SC Freiburg,34,14,9,11,45,40,5,51
German Bundesliga 2012/13,Eintracht Frankfurt,34,14,9,11,49,46,3,51
German Bundesliga 2012/13,Hamburg,34,14,6,14,42,53,-11,48
German Bundesliga 2012/13,M'gladbach,34,12,11,11,45,49,-4,47
German Bundesliga 2012/13,Hannover 96,34,13,6,15,60,62,-2,45
German Bundesliga 2012/13,FC Nurnberg,34,11,11,12,39,47,-8,44
German Bundesliga 2012/13,Wolfsburg,34,10,13,11,47,52,-5,43
German Bundesliga 2012/13,Stuttgart,34,12,7,15,37,55,-18,43
German Bundesliga 2012/13,Mainz,34,10,12,12,42,44,-2,42
German Bundesliga 2012/13,Werder Bremen,34,8,10,16,50,66,-16,34
German Bundesliga 2012/13,FC Augsburg,34,8,9,17,33,51,-18,33
German Bundesliga 2012/13,Hoffenheim,34,8,7,19,42,67,-25,31
German Bundesliga 2012/13,Fortuna Dusseldorf,34,7,9,18,39,57,-18,30
German Bundesliga 2012/13,Greuther Furth,34,4,9,21,26,60,-34,21
German Bundesliga 2013/14,Bayern Munich,34,29,3,2,94,23,71,90
German Bundesliga 2013/14,Borussia Dortmund,34,22,5,7,80,38,42,71
German Bundesliga 2013/14,Schalke,34,19,7,8,63,43,20,64
German Bundesliga 2013/14,Bayer Leverkusen,34,19,4,11,60,41,19,61
German Bundesliga 2013/14,Wolfsburg,34,18,6,10,63,50,13,60
German Bundesliga 2013/14,M'gladbach,34,16,7,11,59,43,16,55
German Bundesliga 2013/14,Mainz,34,16,5,13,52,54,-2,53
German Bundesliga 2013/14,FC Augsburg,34,15,7,12,47,47,0,52
German Bundesliga 2013/14,Hoffenheim,34,11,11,12,72,70,2,44
German Bundesliga 2013/14,Hannover 96,34,12,6,16,46,59,-13,42
German Bundesliga 2013/14,Hertha Berlin,34,11,8,15,40,48,-8,41
German Bundesliga 2013/14,Werder Bremen,34,10,9,15,42,66,-24,39
German Bundesliga 2013/14,Eintracht Frankfurt,34,9,9,16,40,57,-17,36
German Bundesliga 2013/14,SC Freiburg,34,9,9,16,43,61,-18,36
German Bundesliga 2013/14,Stuttgart,34,8,8,18,49,62,-13,32
German Bundesliga 2013/14,Hamburg,34,7,6,21,51,75,-24,27
German Bundesliga 2013/14,FC Nurnberg,34,5,11,18,37,70,-33,26
German Bundesliga 2013/14,Eintracht Braunschweig,34,6,7,21,29,60,-31,25
German Bundesliga 2014/15,Bayern Munich,34,25,4,5,80,18,62,79
German Bundesliga 2014/15,Wolfsburg,34,20,9,5,72,38,34,69
German Bundesliga 2014/15,M'gladbach,34,19,9,6,53,26,27,66
German Bundesliga 2014/15,Bayer Leverkusen,34,17,10,7,62,37,25,61
German Bundesliga 2014/15,FC Augsburg,34,15,4,15,43,43,0,49
German Bundesliga 2014/15,Schalke,34,13,9,12,42,40,2,48
German Bundesliga 2014/15,Borussia Dortmund,34,13,7,14,47,42,5,46
German Bundesliga 2014/15,Hoffenheim,34,12,8,14,49,55,-6,44
German Bundesliga 2014/15,Eintracht Frankfurt,34,11,10,13,56,62,-6,43
German Bundesliga 2014/15,Werder Bremen,34,11,10,13,50,65,-15,43
German Bundesliga 2014/15,Mainz,34,9,13,12,45,47,-2,40
German Bundesliga 2014/15,Cologne,34,9,13,12,34,40,-6,40
German Bundesliga 2014/15,Hannover 96,34,9,10,15,40,56,-16,37
German Bundesliga 2014/15,Stuttgart,34,9,9,16,42,60,-18,36
German Bundesliga 2014/15,Hertha Berlin,34,9,8,17,36,52,-16,35
German Bundesliga 2014/15,Hamburg,34,9,8,17,25,50,-25,35
German Bundesliga 2014/15,SC Freiburg,34,7,13,14,36,47,-11,34
German Bundesliga 2014/15,SC Paderborn 07,34,7,10,17,31,65,-34,31
German Bundesliga 2015/16,Bayern Munich,34,28,4,2,80,17,63,88
German Bundesliga 2015/16,Borussia Dortmund,34,24,6,4,82,34,48,78
German Bundesliga 2015/16,Bayer Leverkusen,34,18,6,10,56,40,16,60
German Bundesliga 2015/16,M'gladbach,34,17,4,13,67,50,17,55
German Bundesliga 2015/16,Schalke,34,15,7,12,51,49,2,52
German Bundesliga 2015/16,Mainz,34,14,8,12,46,42,4,50
German Bundesliga 2015/16,Hertha Berlin,34,14,8,12,42,42,0,50
German Bundesliga 2015/16,Wolfsburg,34,12,9,13,47,49,-2,45
German Bundesliga 2015/16,Cologne,34,10,13,11,38,42,-4,43
German Bundesliga 2015/16,Hamburg,34,11,8,15,40,46,-6,41
German Bundesliga 2015/16,FC Ingolstadt 04,34,10,10,14,33,42,-9,40
German Bundesliga 2015/16,FC Augsburg,34,9,11,14,42,52,-10,38
German Bundesliga 2015/16,Werder Bremen,34,10,8,16,50,65,-15,38
German Bundesliga 2015/16,SV Darmstadt 98,34,9,11,14,38,53,-15,38
German Bundesliga 2015/16,Hoffenheim,34,9,10,15,39,54,-15,37
German Bundesliga 2015/16,Eintracht Frankfurt,34,9,9,16,34,52,-18,36
German Bundesliga 2015/16,Stuttgart,34,9,6,19,50,75,-25,33
German Bundesliga 2015/16,Hannover 96,34,7,4,23,31,62,-31,25
German Bundesliga 2016/17,Bayern Munich,34,25,7,2,89,22,67,82
German Bundesliga 2016/17,RB Leipzig,34,20,7,7,66,39,27,67
German Bundesliga 2016/17,Borussia Dortmund,34,18,10,6,72,40,32,64
German Bundesliga 2016/17,Hoffenheim,34,16,14,4,64,37,27,62
German Bundesliga 2016/17,Cologne,34,12,13,9,51,42,9,49
German Bundesliga 2016/17,Hertha Berlin,34,15,4,15,43,47,-4,49
German Bundesliga 2016/17,SC Freiburg,34,14,6,14,42,60,-18,48
German Bundesliga 2016/17,Werder Bremen,34,13,6,15,61,64,-3,45
German Bundesliga 2016/17,M'gladbach,34,12,9,13,45,49,-4,45
German Bundesliga 2016/17,Schalke,34,11,10,13,45,40,5,43
German Bundesliga 2016/17,Eintracht Frankfurt,34,11,9,14,36,43,-7,42
German Bundesliga 2016/17,Bayer Leverkusen,34,11,8,15,53,55,-2,41
German Bundesliga 2016/17,FC Augsburg,34,9,11,14,35,51,-16,38
German Bundesliga 2016/17,Hamburg,34,10,8,16,33,61,-28,38
German Bundesliga 2016/17,Mainz,34,10,7,17,44,55,-11,37
German Bundesliga 2016/17,Wolfsburg,34,10,7,17,34,52,-18,37
German Bundesliga 2016/17,FC Ingolstadt 04,34,8,8,18,36,57,-21,32
German Bundesliga 2016/17,SV Darmstadt 98,34,7,4,23,28,63,-35,25
German Bundesliga 2017/18,Bayern Munich,34,27,3,4,92,28,64,84
German Bundesliga 2017/18,Schalke,34,18,9,7,53,37,16,63
German Bundesliga 2017/18,Hoffenheim,34,15,10,9,66,48,18,55
German Bundesliga 2017/18,Borussia Dortmund,34,15,10,9,64,47,17,55
German Bundesliga 2017/18,Bayer Leverkusen,34,15,10,9,58,44,14,55
German Bundesliga 2017/18,RB Leipzig,34,15,8,11,57,53,4,53
German Bundesliga 2017/18,Stuttgart,34,15,6,13,36,36,0,51
German Bundesliga 2017/18,Eintracht Frankfurt,34,14,7,13,45,45,0,49
German Bundesliga 2017/18,M'gladbach,34,13,8,13,47,52,-5,47
German Bundesliga 2017/18,Hertha Berlin,34,10,13,11,43,46,-3,43
German Bundesliga 2017/18,Werder Bremen,34,10,12,12,37,40,-3,42
German Bundesliga 2017/18,FC Augsburg,34,10,11,13,43,46,-3,41
German Bundesliga 2017/18,Hannover 96,34,10,9,15,44,54,-10,39
German Bundesliga 2017/18,Mainz,34,9,9,16,38,52,-14,36
German Bundesliga 2017/18,SC Freiburg,34,8,12,14,32,56,-24,36
German Bundesliga 2017/18,Wolfsburg,34,6,15,13,36,48,-12,33
German Bundesliga 2017/18,Hamburg,34,8,7,19,29,53,-24,31
German Bundesliga 2017/18,Cologne,34,5,7,22,35,70,-35,22
German Bundesliga 2018/19,Bayern Munich,34,24,6,4,88,32,56,78
German Bundesliga 2018/19,Borussia Dortmund,34,23,7,4,81,44,37,76
German Bundesliga 2018/19,RB Leipzig,34,19,9,6,63,29,34,66
German Bundesliga 2018/19,Bayer Leverkusen,34,18,4,12,69,52,17,58
German Bundesliga 2018/19,M'gladbach,34,16,7,11,55,42,13,55
German Bundesliga 2018/19,Wolfsburg,34,16,7,11,62,50,12,55
German Bundesliga 2018/19,Eintracht Frankfurt,34,15,9,10,60,48,12,54
German Bundesliga 2018/19,Werder Bremen,34,14,11,9,58,49,9,53
German Bundesliga 2018/19,Hoffenheim,34,13,12,9,70,52,18,51
German Bundesliga 2018/19,Fortuna Dusseldorf,34,13,5,16,49,65,-16,44
German Bundesliga 2018/19,Hertha Berlin,34,11,10,13,49,57,-8,43
German Bundesliga 2018/19,Mainz,34,12,7,15,46,57,-11,43
German Bundesliga 2018/19,SC Freiburg,34,8,12,14,46,61,-15,36
German Bundesliga 2018/19,Schalke,34,8,9,17,37,55,-18,33
German Bundesliga 2018/19,FC Augsburg,34,8,8,18,51,71,-20,32
German Bundesliga 2018/19,Stuttgart,34,7,7,20,32,70,-38,28
German Bundesliga 2018/19,Hannover 96,34,5,6,23,31,71,-40,21
German Bundesliga 2018/19,FC Nurnberg,34,3,10,21,26,68,-42,19
German Bundesliga 2019/20,Bayern Munich,34,26,4,4,100,32,68,82
German Bundesliga 2019/20,Borussia Dortmund,34,21,6,7,84,41,43,69
German Bundesliga 2019/20,RB Leipzig,34,18,12,4,81,37,44,66
German Bundesliga 2019/20,M'gladbach,34,20,5,9,66,40,26,65
German Bundesliga 2019/20,Bayer Leverkusen,34,19,6,9,61,44,17,63
German Bundesliga 2019/20,Hoffenheim,34,15,7,12,53,53,0,52
German Bundesliga 2019/20,Wolfsburg,34,13,10,11,48,46,2,49
German Bundesliga 2019/20,SC Freiburg,34,13,9,12,48,47,1,48
German Bundesliga 2019/20,Eintracht Frankfurt,34,13,6,15,59,60,-1,45
German Bundesliga 2019/20,Hertha Berlin,34,11,8,15,48,59,-11,41
German Bundesliga 2019/20,1. FC Union Berlin,34,12,5,17,41,58,-17,41
German Bundesliga 2019/20,Schalke,34,9,12,13,38,58,-20,39
German Bundesliga 2019/20,Mainz,34,11,4,19,44,65,-21,37
German Bundesliga 2019/20,Cologne,34,10,6,18,51,69,-18,36
German Bundesliga 2019/20,FC Augsburg,34,9,9,16,45,63,-18,36
German Bundesliga 2019/20,Werder Bremen,34,8,7,19,42,69,-27,31
German Bundesliga 2019/20,Fortuna Dusseldorf,34,6,12,16,36,67,-31,30
German Bundesliga 2019/20,SC Paderborn 07,34,4,8,22,37,74,-37,20
German Bundesliga 2020/21,Bayern Munich,6,5,0,1,24,9,15,15
German Bundesliga 2020/21,Borussia Dortmund,6,5,0,1,13,2,11,15
German Bundesliga 2020/21,RB Leipzig,6,4,1,1,12,4,8,13
German Bundesliga 2020/21,Bayer Leverkusen,6,3,3,0,10,5,5,12
German Bundesliga 2020/21,M'gladbach,6,3,2,1,9,8,1,11
German Bundesliga 2020/21,FC Augsburg,6,3,1,2,9,7,2,10
German Bundesliga 2020/21,Stuttgart,6,2,3,1,11,7,4,9
German Bundesliga 2020/21,1. FC Union Berlin,6,2,3,1,11,7,4,9
German Bundesliga 2020/21,Werder Bremen,6,2,3,1,8,8,0,9
German Bundesliga 2020/21,Eintracht Frankfurt,6,2,3,1,8,10,-2,9
German Bundesliga 2020/21,Wolfsburg,6,1,5,0,5,4,1,8
German Bundesliga 2020/21,Hoffenheim,6,2,1,3,10,10,0,7
German Bundesliga 2020/21,SC Freiburg,6,1,3,2,8,13,-5,6
German Bundesliga 2020/21,Hertha Berlin,6,1,1,4,10,13,-3,4
German Bundesliga 2020/21,Arminia Bielefeld,6,1,1,4,4,10,-6,4
German Bundesliga 2020/21,Cologne,6,0,2,4,6,11,-5,2
German Bundesliga 2020/21,Schalke,6,0,2,4,3,20,-17,2
German Bundesliga 2020/21,Mainz,6,0,0,6,5,18,-13,0
UEFA Champions League - Group A 2009/10,Bordeaux,6,5,1,0,9,2,7,16
UEFA Champions League - Group A 2009/10,Bayern Munich,6,3,1,2,9,5,4,10
UEFA Champions League - Group A 2009/10,Juventus,6,2,2,2,4,7,-3,8
UEFA Champions League - Group A 2009/10,Maccabi Haifa (Isr),6,0,0,6,0,8,-8,0
UEFA Champions League - Group B 2009/10,Manchester United,6,4,1,1,10,6,4,13
UEFA Champions League - Group B 2009/10,CSKA Moscow,6,3,1,2,10,10,0,10
UEFA Champions League - Group B 2009/10,Wolfsburg,6,2,1,3,9,8,1,7
UEFA Champions League - Group B 2009/10,Besiktas,6,1,1,4,3,8,-5,4
UEFA Champions League - Group C 2009/10,Real Madrid,6,4,1,1,15,7,8,13
UEFA Champions League - Group C 2009/10,AC Milan,6,2,3,1,8,7,1,9
UEFA Champions League - Group C 2009/10,Marseille,6,2,1,3,10,10,0,7
UEFA Champions League - Group C 2009/10,FC Zurich,6,1,1,4,5,14,-9,4
UEFA Champions League - Group D 2009/10,Chelsea,6,4,2,0,11,4,7,14
UEFA Champions League - Group D 2009/10,FC Porto,6,4,0,2,8,3,5,12
UEFA Champions League - Group D 2009/10,Atletico Madrid,6,0,3,3,3,12,-9,3
UEFA Champions League - Group D 2009/10,Apoel Nicosia,6,0,3,3,4,7,-3,3
UEFA Champions League - Group E 2009/10,Fiorentina,6,5,0,1,14,7,7,15
UEFA Champions League - Group E 2009/10,Lyon,6,4,1,1,12,3,9,13
UEFA Champions League - Group E 2009/10,Liverpool,6,2,1,3,5,7,-2,7
UEFA Champions League - Group E 2009/10,Debreceni Vasutas Sport Club,6,0,0,6,5,19,-14,0
UEFA Champions League - Group F 2009/10,Barcelona,6,3,2,1,7,3,4,11
UEFA Champions League - Group F 2009/10,Inter Milan,6,2,3,1,7,6,1,9
UEFA Champions League - Group F 2009/10,Rubin Kazan,6,1,3,2,4,7,-3,6
UEFA Champions League - Group F 2009/10,Dynamo Kiev,6,1,2,3,7,9,-2,5
UEFA Champions League - Group G 2009/10,Sevilla,6,4,1,1,11,4,7,13
UEFA Champions League - Group G 2009/10,Stuttgart,6,2,3,1,9,7,2,9
UEFA Champions League - Group G 2009/10,Unirea Urziceni,6,2,2,2,8,8,0,8
UEFA Champions League - Group G 2009/10,Rangers,6,0,2,4,4,13,-9,2
UEFA Champions League - Group H 2009/10,Arsenal,6,4,1,1,12,5,7,13
UEFA Champions League - Group H 2009/10,Olympiakos FC,6,3,1,2,4,5,-1,10
UEFA Champions League - Group H 2009/10,Standard Liege,6,1,2,3,7,9,-2,5
UEFA Champions League - Group H 2009/10,AZ Alkmaar,6,0,4,2,4,8,-4,4
UEFA Champions League - Group A 2010/11,Tottenham Hotspur,6,3,2,1,18,11,7,11
UEFA Champions League - Group A 2010/11,Inter Milan,6,3,1,2,12,11,1,10
UEFA Champions League - Group A 2010/11,FC Twente,6,1,3,2,9,11,-2,6
UEFA Champions League - Group A 2010/11,Werder Bremen,6,1,2,3,6,12,-6,5
UEFA Champions League - Group B 2010/11,Schalke,6,4,1,1,10,3,7,13
UEFA Champions League - Group B 2010/11,Lyon,6,3,1,2,11,10,1,10
UEFA Champions League - Group B 2010/11,Benfica,6,2,0,4,7,12,-5,6
UEFA Champions League - Group B 2010/11,Hapoel Tel-Aviv,6,1,2,3,7,10,-3,5
UEFA Champions League - Group C 2010/11,Manchester United,6,4,2,0,7,1,6,14
UEFA Champions League - Group C 2010/11,Valencia,6,3,2,1,15,4,11,11
UEFA Champions League - Group C 2010/11,Rangers,6,1,3,2,3,6,-3,6
UEFA Champions League - Group C 2010/11,Bursaspor,6,0,1,5,2,16,-14,1
UEFA Champions League - Group D 2010/11,Barcelona,6,4,2,0,14,3,11,14
UEFA Champions League - Group D 2010/11,FC Copenhagen,6,3,1,2,7,5,2,10
UEFA Champions League - Group D 2010/11,Rubin Kazan,6,1,3,2,2,4,-2,6
UEFA Champions League - Group D 2010/11,Panathinaikos,6,0,2,4,2,13,-11,2
UEFA Champions League - Group E 2010/11,Bayern Munich,6,5,0,1,16,6,10,15
UEFA Champions League - Group E 2010/11,Roma,6,3,1,2,10,11,-1,10
UEFA Champions League - Group E 2010/11,Basel,6,2,0,4,8,11,-3,6
UEFA Champions League - Group E 2010/11,CFR Cluj-Napoca,6,1,1,4,6,12,-6,4
UEFA Champions League - Group F 2010/11,Chelsea,6,5,0,1,14,4,10,15
UEFA Champions League - Group F 2010/11,Marseille,6,4,0,2,12,3,9,12
UEFA Champions League - Group F 2010/11,Spartak Moscow,6,3,0,3,7,10,-3,9
UEFA Champions League - Group F 2010/11,MSK Zilina,6,0,0,6,3,19,-16,0
UEFA Champions League - Group G 2010/11,Real Madrid,6,5,1,0,15,2,13,16
UEFA Champions League - Group G 2010/11,AC Milan,6,2,2,2,7,7,0,8
UEFA Champions League - Group G 2010/11,Ajax,6,2,1,3,6,10,-4,7
UEFA Champions League - Group G 2010/11,Auxerre,6,1,0,5,3,12,-9,3
UEFA Champions League - Group H 2010/11,Shakhtar Donetsk,6,5,0,1,12,6,6,15
UEFA Champions League - Group H 2010/11,Arsenal,6,4,0,2,18,7,11,12
UEFA Champions League - Group H 2010/11,Braga,6,3,0,3,5,11,-6,9
UEFA Champions League - Group H 2010/11,Partizan Belgrade,6,0,0,6,2,13,-11,0
UEFA Champions League - Group A 2011/12,Bayern Munich,6,4,1,1,11,6,5,13
UEFA Champions League - Group A 2011/12,Napoli,6,3,2,1,10,6,4,11
UEFA Champions League - Group A 2011/12,Manchester City,6,3,1,2,9,6,3,10
UEFA Champions League - Group A 2011/12,Villarreal,6,0,0,6,2,14,-12,0
UEFA Champions League - Group B 2011/12,Inter Milan,6,3,1,2,8,7,1,10
UEFA Champions League - Group B 2011/12,CSKA Moscow,6,2,2,2,9,8,1,8
UEFA Champions League - Group B 2011/12,Trabzonspor,6,1,4,1,3,5,-2,7
UEFA Champions League - Group B 2011/12,Lille,6,1,3,2,6,6,0,6
UEFA Champions League - Group C 2011/12,Benfica,6,3,3,0,8,4,4,12
UEFA Champions League - Group C 2011/12,Basel,6,3,2,1,11,10,1,11
UEFA Champions League - Group C 2011/12,Manchester United,6,2,3,1,11,8,3,9
UEFA Champions League - Group C 2011/12,CS Otelul Galati,6,0,0,6,3,11,-8,0
UEFA Champions League - Group D 2011/12,Real Madrid,6,6,0,0,19,2,17,18
UEFA Champions League - Group D 2011/12,Lyon,6,2,2,2,9,7,2,8
UEFA Champions League - Group D 2011/12,Ajax,6,2,2,2,6,6,0,8
UEFA Champions League - Group D 2011/12,Dinamo Zagreb,6,0,0,6,3,22,-19,0
UEFA Champions League - Group E 2011/12,Chelsea,6,3,2,1,13,4,9,11
UEFA Champions League - Group E 2011/12,Bayer Leverkusen,6,3,1,2,8,8,0,10
UEFA Champions League - Group E 2011/12,Valencia,6,2,2,2,12,7,5,8
UEFA Champions League - Group E 2011/12,Genk,6,0,3,3,2,16,-14,3
UEFA Champions League - Group F 2011/12,Arsenal,6,3,2,1,7,6,1,11
UEFA Champions League - Group F 2011/12,Marseille,6,3,1,2,7,4,3,10
UEFA Champions League - Group F 2011/12,Olympiakos FC,6,3,0,3,8,6,2,9
UEFA Champions League - Group F 2011/12,Borussia Dortmund,6,1,1,4,6,12,-6,4
UEFA Champions League - Group G 2011/12,Apoel Nicosia,6,2,3,1,6,6,0,9
UEFA Champions League - Group G 2011/12,Zenit St. Petersburg,6,2,3,1,7,5,2,9
UEFA Champions League - Group G 2011/12,FC Porto,6,2,2,2,7,7,0,8
UEFA Champions League - Group G 2011/12,Shakhtar Donetsk,6,1,2,3,6,8,-2,5
UEFA Champions League - Group H 2011/12,Barcelona,6,5,1,0,20,4,16,16
UEFA Champions League - Group H 2011/12,AC Milan,6,2,3,1,11,8,3,9
UEFA Champions League - Group H 2011/12,FC Viktoria Plzen,6,1,2,3,4,11,-7,5
UEFA Champions League - Group H 2011/12,BATE Borisov,6,0,2,4,2,14,-12,2
UEFA Champions League - Group A 2012/13,Paris Saint-Germain,6,5,0,1,14,3,11,15
UEFA Champions League - Group A 2012/13,FC Porto,6,4,1,1,10,4,6,13
UEFA Champions League - Group A 2012/13,Dynamo Kiev,6,1,2,3,6,10,-4,5
UEFA Champions League - Group A 2012/13,Dinamo Zagreb,6,0,1,5,1,14,-13,1
UEFA Champions League - Group B 2012/13,Schalke,6,3,3,0,10,6,4,12
UEFA Champions League - Group B 2012/13,Arsenal,6,3,1,2,10,8,2,10
UEFA Champions League - Group B 2012/13,Olympiakos FC,6,3,0,3,9,9,0,9
UEFA Champions League - Group B 2012/13,Montpellier,6,0,2,4,6,12,-6,2
UEFA Champions League - Group C 2012/13,Malaga,6,3,3,0,12,5,7,12
UEFA Champions League - Group C 2012/13,AC Milan,6,2,2,2,7,6,1,8
UEFA Champions League - Group C 2012/13,Zenit St. Petersburg,6,2,1,3,6,9,-3,7
UEFA Champions League - Group C 2012/13,Anderlecht,6,1,2,3,4,9,-5,5
UEFA Champions League - Group D 2012/13,Borussia Dortmund,6,4,2,0,11,5,6,14
UEFA Champions League - Group D 2012/13,Real Madrid,6,3,2,1,15,9,6,11
UEFA Champions League - Group D 2012/13,Ajax,6,1,1,4,8,16,-8,4
UEFA Champions League - Group D 2012/13,Manchester City,6,0,3,3,7,11,-4,3
UEFA Champions League - Group E 2012/13,Juventus,6,3,3,0,12,4,8,12
UEFA Champions League - Group E 2012/13,Shakhtar Donetsk,6,3,1,2,12,8,4,10
UEFA Champions League - Group E 2012/13,Chelsea,6,3,1,2,16,10,6,10
UEFA Champions League - Group E 2012/13,FC Nordsjaelland,6,0,1,5,4,22,-18,1
UEFA Champions League - Group F 2012/13,Bayern Munich,6,4,1,1,15,7,8,13
UEFA Champions League - Group F 2012/13,Valencia,6,4,1,1,12,5,7,13
UEFA Champions League - Group F 2012/13,BATE Borisov,6,2,0,4,9,15,-6,6
UEFA Champions League - Group F 2012/13,Lille,6,1,0,5,4,13,-9,3
UEFA Champions League - Group G 2012/13,Barcelona,6,4,1,1,11,5,6,13
UEFA Champions League - Group G 2012/13,Celtic,6,3,1,2,9,8,1,10
UEFA Champions League - Group G 2012/13,Benfica,6,2,2,2,5,5,0,8
UEFA Champions League - Group G 2012/13,Spartak Moscow,6,1,0,5,7,14,-7,3
UEFA Champions League - Group H 2012/13,Manchester United,6,4,0,2,9,6,3,12
UEFA Champions League - Group H 2012/13,Galatasaray,6,3,1,2,7,6,1,10
UEFA Champions League - Group H 2012/13,CFR Cluj-Napoca,6,3,1,2,9,7,2,10
UEFA Champions League - Group H 2012/13,Braga,6,1,0,5,7,13,-6,3
UEFA Champions League - Group A 2013/14,Manchester United,6,4,2,0,12,3,9,14
UEFA Champions League - Group A 2013/14,Bayer Leverkusen,6,3,1,2,9,10,-1,10
UEFA Champions League - Group A 2013/14,Shakhtar Donetsk,6,2,2,2,7,6,1,8
UEFA Champions League - Group A 2013/14,Real Sociedad,6,0,1,5,1,10,-9,1
UEFA Champions League - Group B 2013/14,Real Madrid,6,5,1,0,20,5,15,16
UEFA Champions League - Group B 2013/14,Galatasaray,6,2,1,3,8,14,-6,7
UEFA Champions League - Group B 2013/14,Juventus,6,1,3,2,9,9,0,6
UEFA Champions League - Group B 2013/14,FC Copenhagen,6,1,1,4,4,13,-9,4
UEFA Champions League - Group C 2013/14,Paris Saint-Germain,6,4,1,1,16,5,11,13
UEFA Champions League - Group C 2013/14,Olympiakos FC,6,3,1,2,10,8,2,10
UEFA Champions League - Group C 2013/14,Benfica,6,3,1,2,8,8,0,10
UEFA Champions League - Group C 2013/14,Anderlecht,6,0,1,5,4,17,-13,1
UEFA Champions League - Group D 2013/14,Bayern Munich,6,5,0,1,17,5,12,15
UEFA Champions League - Group D 2013/14,Manchester City,6,5,0,1,18,10,8,15
UEFA Champions League - Group D 2013/14,FC Viktoria Plzen,6,1,0,5,6,17,-11,3
UEFA Champions League - Group D 2013/14,CSKA Moscow,6,1,0,5,8,17,-9,3
UEFA Champions League - Group E 2013/14,Chelsea,6,4,0,2,12,3,9,12
UEFA Champions League - Group E 2013/14,Schalke,6,3,1,2,6,6,0,10
UEFA Champions League - Group E 2013/14,Basel,6,2,2,2,5,6,-1,8
UEFA Champions League - Group E 2013/14,FC Steaua Bucuresti,6,0,3,3,2,10,-8,3
UEFA Champions League - Group F 2013/14,Borussia Dortmund,6,4,0,2,11,6,5,12
UEFA Champions League - Group F 2013/14,Arsenal,6,4,0,2,8,5,3,12
UEFA Champions League - Group F 2013/14,Napoli,6,4,0,2,10,9,1,12
UEFA Champions League - Group F 2013/14,Marseille,6,0,0,6,5,14,-9,0
UEFA Champions League - Group G 2013/14,Atletico Madrid,6,5,1,0,15,3,12,16
UEFA Champions League - Group G 2013/14,Zenit St. Petersburg,6,1,3,2,5,9,-4,6
UEFA Champions League - Group G 2013/14,FC Porto,6,1,2,3,4,7,-3,5
UEFA Champions League - Group G 2013/14,FK Austria Wien,6,1,2,3,5,10,-5,5
UEFA Champions League - Group H 2013/14,Barcelona,6,4,1,1,16,5,11,13
UEFA Champions League - Group H 2013/14,AC Milan,6,2,3,1,8,5,3,9
UEFA Champions League - Group H 2013/14,Ajax,6,2,2,2,5,8,-3,8
UEFA Champions League - Group H 2013/14,Celtic,6,1,0,5,3,14,-11,3
UEFA Champions League - Group A 2014/15,Atletico Madrid,6,4,1,1,14,3,11,13
UEFA Champions League - Group A 2014/15,Juventus,6,3,1,2,7,4,3,10
UEFA Champions League - Group A 2014/15,Olympiakos FC,6,3,0,3,10,13,-3,9
UEFA Champions League - Group A 2014/15,Malmo FF,6,1,0,5,4,15,-11,3
UEFA Champions League - Group B 2014/15,Real Madrid,6,6,0,0,16,2,14,18
UEFA Champions League - Group B 2014/15,Basel,6,2,1,3,7,8,-1,7
UEFA Champions League - Group B 2014/15,Liverpool,6,1,2,3,5,9,-4,5
UEFA Champions League - Group B 2014/15,Ludogorets,6,1,1,4,5,14,-9,4
UEFA Champions League - Group C 2014/15,Monaco,6,3,2,1,4,1,3,11
UEFA Champions League - Group C 2014/15,Bayer Leverkusen,6,3,1,2,7,4,3,10
UEFA Champions League - Group C 2014/15,Zenit St. Petersburg,6,2,1,3,4,6,-2,7
UEFA Champions League - Group C 2014/15,Benfica,6,1,2,3,2,6,-4,5
UEFA Champions League - Group D 2014/15,Borussia Dortmund,6,4,1,1,14,4,10,13
UEFA Champions League - Group D 2014/15,Arsenal,6,4,1,1,15,8,7,13
UEFA Champions League - Group D 2014/15,Anderlecht,6,1,3,2,8,10,-2,6
UEFA Champions League - Group D 2014/15,Galatasaray,6,0,1,5,4,19,-15,1
UEFA Champions League - Group E 2014/15,Bayern Munich,6,5,0,1,16,4,12,15
UEFA Champions League - Group E 2014/15,Manchester City,6,2,2,2,9,8,1,8
UEFA Champions League - Group E 2014/15,Roma,6,1,2,3,8,14,-6,5
UEFA Champions League - Group E 2014/15,CSKA Moscow,6,1,2,3,6,13,-7,5
UEFA Champions League - Group F 2014/15,Barcelona,6,5,0,1,15,5,10,15
UEFA Champions League - Group F 2014/15,Paris Saint-Germain,6,4,1,1,10,7,3,13
UEFA Champions League - Group F 2014/15,Ajax,6,1,2,3,8,10,-2,5
UEFA Champions League - Group F 2014/15,Apoel Nicosia,6,0,1,5,1,12,-11,1
UEFA Champions League - Group G 2014/15,Chelsea,6,4,2,0,17,3,14,14
UEFA Champions League - Group G 2014/15,Schalke,6,2,2,2,9,14,-5,8
UEFA Champions League - Group G 2014/15,Sporting Lisbon,6,2,1,3,12,12,0,7
UEFA Champions League - Group G 2014/15,Maribor,6,0,3,3,4,13,-9,3
UEFA Champions League - Group H 2014/15,FC Porto,6,4,2,0,16,4,12,14
UEFA Champions League - Group H 2014/15,Shakhtar Donetsk,6,2,3,1,15,4,11,9
UEFA Champions League - Group H 2014/15,Athletic Bilbao,6,2,1,3,5,6,-1,7
UEFA Champions League - Group H 2014/15,BATE Borisov,6,1,0,5,2,24,-22,3
UEFA Champions League - Group A 2015/16,Real Madrid,6,5,1,0,19,3,16,16
UEFA Champions League - Group A 2015/16,Paris Saint-Germain,6,4,1,1,12,1,11,13
UEFA Champions League - Group A 2015/16,Shakhtar Donetsk,6,1,0,5,7,14,-7,3
UEFA Champions League - Group A 2015/16,Malmo FF,6,1,0,5,1,21,-20,3
UEFA Champions League - Group B 2015/16,Wolfsburg,6,4,0,2,9,6,3,12
UEFA Champions League - Group B 2015/16,PSV Eindhoven,6,3,1,2,8,7,1,10
UEFA Champions League - Group B 2015/16,Manchester United,6,2,2,2,7,7,0,8
UEFA Champions League - Group B 2015/16,CSKA Moscow,6,1,1,4,5,9,-4,4
UEFA Champions League - Group C 2015/16,Atletico Madrid,6,4,1,1,11,3,8,13
UEFA Champions League - Group C 2015/16,Benfica,6,3,1,2,10,8,2,10
UEFA Champions League - Group C 2015/16,Galatasaray,6,1,2,3,6,10,-4,5
UEFA Champions League - Group C 2015/16,Astana,6,0,4,2,5,11,-6,4
UEFA Champions League - Group D 2015/16,Manchester City,6,4,0,2,12,8,4,12
UEFA Champions League - Group D 2015/16,Juventus,6,3,2,1,6,3,3,11
UEFA Champions League - Group D 2015/16,Sevilla,6,2,0,4,8,11,-3,6
UEFA Champions League - Group D 2015/16,M'gladbach,6,1,2,3,8,12,-4,5
UEFA Champions League - Group E 2015/16,Barcelona,6,4,2,0,15,4,11,14
UEFA Champions League - Group E 2015/16,Roma,6,1,3,2,11,16,-5,6
UEFA Champions League - Group E 2015/16,Bayer Leverkusen,6,1,3,2,13,12,1,6
UEFA Champions League - Group E 2015/16,BATE Borisov,6,1,2,3,5,12,-7,5
UEFA Champions League - Group F 2015/16,Bayern Munich,6,5,0,1,19,3,16,15
UEFA Champions League - Group F 2015/16,Arsenal,6,3,0,3,12,10,2,9
UEFA Champions League - Group F 2015/16,Olympiakos FC,6,3,0,3,6,13,-7,9
UEFA Champions League - Group F 2015/16,Dinamo Zagreb,6,1,0,5,3,14,-11,3
UEFA Champions League - Group G 2015/16,Chelsea,6,4,1,1,13,3,10,13
UEFA Champions League - Group G 2015/16,Dynamo Kiev,6,3,2,1,8,4,4,11
UEFA Champions League - Group G 2015/16,FC Porto,6,3,1,2,9,8,1,10
UEFA Champions League - Group G 2015/16,Maccabi Tel Aviv,6,0,0,6,1,16,-15,0
UEFA Champions League - Group H 2015/16,Zenit St. Petersburg,6,5,0,1,13,6,7,15
UEFA Champions League - Group H 2015/16,AA Gent,6,3,1,2,8,7,1,10
UEFA Champions League - Group H 2015/16,Valencia,6,2,0,4,5,9,-4,6
UEFA Champions League - Group H 2015/16,Lyon,6,1,1,4,5,9,-4,4
UEFA Champions League - Group A 2016/17,Arsenal,6,4,2,0,18,6,12,14
UEFA Champions League - Group A 2016/17,Paris Saint-Germain,6,3,3,0,13,7,6,12
UEFA Champions League - Group A 2016/17,Ludogorets,6,0,3,3,6,15,-9,3
UEFA Champions League - Group A 2016/17,Basel,6,0,2,4,3,12,-9,2
UEFA Champions League - Group B 2016/17,Napoli,6,3,2,1,11,8,3,11
UEFA Champions League - Group B 2016/17,Benfica,6,2,2,2,10,10,0,8
UEFA Champions League - Group B 2016/17,Besiktas,6,1,4,1,9,14,-5,7
UEFA Champions League - Group B 2016/17,Dynamo Kiev,6,1,2,3,8,6,2,5
UEFA Champions League - Group C 2016/17,Barcelona,6,5,0,1,20,4,16,15
UEFA Champions League - Group C 2016/17,Manchester City,6,2,3,1,12,10,2,9
UEFA Champions League - Group C 2016/17,M'gladbach,6,1,2,3,5,12,-7,5
UEFA Champions League - Group C 2016/17,Celtic,6,0,3,3,5,16,-11,3
UEFA Champions League - Group D 2016/17,Atletico Madrid,6,5,0,1,7,2,5,15
UEFA Champions League - Group D 2016/17,Bayern Munich,6,4,0,2,14,6,8,12
UEFA Champions League - Group D 2016/17,FK Rostov,6,1,2,3,6,12,-6,5
UEFA Champions League - Group D 2016/17,PSV Eindhoven,6,0,2,4,4,11,-7,2
UEFA Champions League - Group E 2016/17,Monaco,6,3,2,1,9,7,2,11
UEFA Champions League - Group E 2016/17,Bayer Leverkusen,6,2,4,0,8,4,4,10
UEFA Champions League - Group E 2016/17,Tottenham Hotspur,6,2,1,3,6,6,0,7
UEFA Champions League - Group E 2016/17,CSKA Moscow,6,0,3,3,5,11,-6,3
UEFA Champions League - Group F 2016/17,Borussia Dortmund,6,4,2,0,21,9,12,14
UEFA Champions League - Group F 2016/17,Real Madrid,6,3,3,0,16,10,6,12
UEFA Champions League - Group F 2016/17,Legia Warsaw,6,1,1,4,9,24,-15,4
UEFA Champions League - Group F 2016/17,Sporting Lisbon,6,1,0,5,5,8,-3,3
UEFA Champions League - Group G 2016/17,Leicester City,6,4,1,1,7,6,1,13
UEFA Champions League - Group G 2016/17,FC Porto,6,3,2,1,9,3,6,11
UEFA Champions League - Group G 2016/17,FC Copenhagen,6,2,3,1,7,2,5,9
UEFA Champions League - Group G 2016/17,Club Brugge,6,0,0,6,2,14,-12,0
UEFA Champions League - Group H 2016/17,Juventus,6,4,2,0,11,2,9,14
UEFA Champions League - Group H 2016/17,Sevilla,6,3,2,1,7,3,4,11
UEFA Champions League - Group H 2016/17,Lyon,6,2,2,2,5,3,2,8
UEFA Champions League - Group H 2016/17,Dinamo Zagreb,6,0,0,6,0,15,-15,0
UEFA Champions League - Group A 2017/18,Manchester United,6,5,0,1,12,3,9,15
UEFA Champions League - Group A 2017/18,Basel,6,4,0,2,11,5,6,12
UEFA Champions League - Group A 2017/18,CSKA Moscow,6,3,0,3,8,10,-2,9
UEFA Champions League - Group A 2017/18,Benfica,6,0,0,6,1,14,-13,0
UEFA Champions League - Group B 2017/18,Paris Saint-Germain,6,5,0,1,25,4,21,15
UEFA Champions League - Group B 2017/18,Bayern Munich,6,5,0,1,13,6,7,15
UEFA Champions League - Group B 2017/18,Celtic,6,1,0,5,5,18,-13,3
UEFA Champions League - Group B 2017/18,Anderlecht,6,1,0,5,2,17,-15,3
UEFA Champions League - Group C 2017/18,Roma,6,3,2,1,9,6,3,11
UEFA Champions League - Group C 2017/18,Chelsea,6,3,2,1,16,8,8,11
UEFA Champions League - Group C 2017/18,Atletico Madrid,6,1,4,1,5,4,1,7
UEFA Champions League - Group C 2017/18,Qarabag FK,6,0,2,4,2,14,-12,2
UEFA Champions League - Group D 2017/18,Barcelona,6,4,2,0,9,1,8,14
UEFA Champions League - Group D 2017/18,Juventus,6,3,2,1,7,5,2,11
UEFA Champions League - Group D 2017/18,Sporting Lisbon,6,2,1,3,8,9,-1,7
UEFA Champions League - Group D 2017/18,Olympiakos FC,6,0,1,5,4,13,-9,1
UEFA Champions League - Group E 2017/18,Liverpool,6,3,3,0,23,6,17,12
UEFA Champions League - Group E 2017/18,Sevilla,6,2,3,1,12,12,0,9
UEFA Champions League - Group E 2017/18,Spartak Moscow,6,1,3,2,9,13,-4,6
UEFA Champions League - Group E 2017/18,Maribor,6,0,3,3,3,16,-13,3
UEFA Champions League - Group F 2017/18,Manchester City,6,5,0,1,14,5,9,15
UEFA Champions League - Group F 2017/18,Shakhtar Donetsk,6,4,0,2,9,9,0,12
UEFA Champions League - Group F 2017/18,Napoli,6,2,0,4,11,11,0,6
UEFA Champions League - Group F 2017/18,Feyenoord,6,1,0,5,5,14,-9,3
UEFA Champions League - Group G 2017/18,Besiktas,6,4,2,0,11,5,6,14
UEFA Champions League - Group G 2017/18,FC Porto,6,3,1,2,15,10,5,10
UEFA Champions League - Group G 2017/18,RB Leipzig,6,2,1,3,10,11,-1,7
UEFA Champions League - Group G 2017/18,Monaco,6,0,2,4,6,16,-10,2
UEFA Champions League - Group H 2017/18,Tottenham Hotspur,6,5,1,0,15,4,11,16
UEFA Champions League - Group H 2017/18,Real Madrid,6,4,1,1,17,7,10,13
UEFA Champions League - Group H 2017/18,Borussia Dortmund,6,0,2,4,7,13,-6,2
UEFA Champions League - Group H 2017/18,Apoel Nicosia,6,0,2,4,2,17,-15,2
UEFA Champions League - Group A 2018/19,Borussia Dortmund,6,4,1,1,10,2,8,13
UEFA Champions League - Group A 2018/19,Atletico Madrid,6,4,1,1,9,6,3,13
UEFA Champions League - Group A 2018/19,Club Brugge,6,1,3,2,6,5,1,6
UEFA Champions League - Group A 2018/19,Monaco,6,0,1,5,2,14,-12,1
UEFA Champions League - Group B 2018/19,Barcelona,6,4,2,0,14,5,9,14
UEFA Champions League - Group B 2018/19,Tottenham Hotspur,6,2,2,2,9,10,-1,8
UEFA Champions League - Group B 2018/19,Inter Milan,6,2,2,2,6,7,-1,8
UEFA Champions League - Group B 2018/19,PSV Eindhoven,6,0,2,4,6,13,-7,2
UEFA Champions League - Group C 2018/19,Paris Saint-Germain,6,3,2,1,17,9,8,11
UEFA Champions League - Group C 2018/19,Liverpool,6,3,0,3,9,7,2,9
UEFA Champions League - Group C 2018/19,Napoli,6,2,3,1,7,5,2,9
UEFA Champions League - Group C 2018/19,Crvena Zvezda,6,1,1,4,5,17,-12,4
UEFA Champions League - Group D 2018/19,FC Porto,6,5,1,0,15,6,9,16
UEFA Champions League - Group D 2018/19,Schalke,6,3,2,1,6,4,2,11
UEFA Champions League - Group D 2018/19,Galatasaray,6,1,1,4,5,8,-3,4
UEFA Champions League - Group D 2018/19,Lokomotiv Moscow,6,1,0,5,4,12,-8,3
UEFA Champions League - Group E 2018/19,Bayern Munich,6,4,2,0,15,5,10,14
UEFA Champions League - Group E 2018/19,Ajax,6,3,3,0,11,5,6,12
UEFA Champions League - Group E 2018/19,Benfica,6,2,1,3,6,11,-5,7
UEFA Champions League - Group E 2018/19,AEK Athens,6,0,0,6,2,13,-11,0
UEFA Champions League - Group F 2018/19,Manchester City,6,4,1,1,16,6,10,13
UEFA Champions League - Group F 2018/19,Lyon,6,1,5,0,12,11,1,8
UEFA Champions League - Group F 2018/19,Shakhtar Donetsk,6,1,3,2,8,16,-8,6
UEFA Champions League - Group F 2018/19,Hoffenheim,6,0,3,3,11,14,-3,3
UEFA Champions League - Group G 2018/19,Real Madrid,6,4,0,2,12,5,7,12
UEFA Champions League - Group G 2018/19,Roma,6,3,0,3,11,8,3,9
UEFA Champions League - Group G 2018/19,FC Viktoria Plzen,6,2,1,3,7,16,-9,7
UEFA Champions League - Group G 2018/19,CSKA Moscow,6,2,1,3,8,9,-1,7
UEFA Champions League - Group H 2018/19,Juventus,6,4,0,2,9,4,5,12
UEFA Champions League - Group H 2018/19,Manchester United,6,3,1,2,7,4,3,10
UEFA Champions League - Group H 2018/19,Valencia,6,2,2,2,6,6,0,8
UEFA Champions League - Group H 2018/19,BSC Young Boys Bern,6,1,1,4,4,12,-8,4
UEFA Champions League - Group A 2019/20,Paris Saint-Germain,6,5,1,0,17,2,15,16
UEFA Champions League - Group A 2019/20,Real Madrid,6,3,2,1,14,8,6,11
UEFA Champions League - Group A 2019/20,Club Brugge,6,0,3,3,4,12,-8,3
UEFA Champions League - Group A 2019/20,Galatasaray,6,0,2,4,1,14,-13,2
UEFA Champions League - Group B 2019/20,Bayern Munich,6,6,0,0,24,5,19,18
UEFA Champions League - Group B 2019/20,Tottenham Hotspur,6,3,1,2,18,14,4,10
UEFA Champions League - Group B 2019/20,Olympiakos FC,6,1,1,4,8,14,-6,4
UEFA Champions League - Group B 2019/20,Crvena Zvezda,6,1,0,5,3,20,-17,3
UEFA Champions League - Group C 2019/20,Manchester City,6,4,2,0,16,4,12,14
UEFA Champions League - Group C 2019/20,Atalanta,6,2,1,3,8,12,-4,7
UEFA Champions League - Group C 2019/20,Shakhtar Donetsk,6,1,3,2,8,13,-5,6
UEFA Champions League - Group C 2019/20,Dinamo Zagreb,6,1,2,3,10,13,-3,5
UEFA Champions League - Group D 2019/20,Juventus,6,5,1,0,12,4,8,16
UEFA Champions League - Group D 2019/20,Atletico Madrid,6,3,1,2,8,5,3,10
UEFA Champions League - Group D 2019/20,Bayer Leverkusen,6,2,0,4,5,9,-4,6
UEFA Champions League - Group D 2019/20,Lokomotiv Moscow,6,1,0,5,4,11,-7,3
UEFA Champions League - Group E 2019/20,Liverpool,6,4,1,1,13,8,5,13
UEFA Champions League - Group E 2019/20,Napoli,6,3,3,0,11,4,7,12
UEFA Champions League - Group E 2019/20,Red Bull Salzburg,6,2,1,3,16,13,3,7
UEFA Champions League - Group E 2019/20,Genk,6,0,1,5,5,20,-15,1
UEFA Champions League - Group F 2019/20,Barcelona,6,4,2,0,9,4,5,14
UEFA Champions League - Group F 2019/20,Borussia Dortmund,6,3,1,2,8,8,0,10
UEFA Champions League - Group F 2019/20,Inter Milan,6,2,1,3,10,9,1,7
UEFA Champions League - Group F 2019/20,Slavia Prague,6,0,2,4,4,10,-6,2
UEFA Champions League - Group G 2019/20,RB Leipzig,6,3,2,1,10,8,2,11
UEFA Champions League - Group G 2019/20,Lyon,6,2,2,2,9,8,1,8
UEFA Champions League - Group G 2019/20,Benfica,6,2,1,3,10,11,-1,7
UEFA Champions League - Group G 2019/20,Zenit St. Petersburg,6,2,1,3,7,9,-2,7
UEFA Champions League - Group H 2019/20,Valencia,6,3,2,1,9,7,2,11
UEFA Champions League - Group H 2019/20,Chelsea,6,3,2,1,11,9,2,11
UEFA Champions League - Group H 2019/20,Ajax,6,3,1,2,12,6,6,10
UEFA Champions League - Group H 2019/20,Lille,6,0,1,5,4,14,-10,1
UEFA Champions League - Group A 2020/21,Bayern Munich,2,2,0,0,6,1,5,6
UEFA Champions League - Group A 2020/21,Atletico Madrid,2,1,0,1,3,6,-3,3
UEFA Champions League - Group A 2020/21,Lokomotiv Moscow,2,0,1,1,3,4,-1,1
UEFA Champions League - Group A 2020/21,Red Bull Salzburg,2,0,1,1,4,5,-1,1
UEFA Champions League - Group B 2020/21,Shakhtar Donetsk,2,1,1,0,3,2,1,4
UEFA Champions League - Group B 2020/21,M'gladbach,2,0,2,0,4,4,0,2
UEFA Champions League - Group B 2020/21,Inter Milan,2,0,2,0,2,2,0,2
UEFA Champions League - Group B 2020/21,Real Madrid,2,0,1,1,4,5,-1,1
UEFA Champions League - Group C 2020/21,Manchester City,2,2,0,0,6,1,5,6
UEFA Champions League - Group C 2020/21,FC Porto,2,1,0,1,3,3,0,3
UEFA Champions League - Group C 2020/21,Olympiakos FC,2,1,0,1,1,2,-1,3
UEFA Champions League - Group C 2020/21,Marseille,2,0,0,2,0,4,-4,0
UEFA Champions League - Group D 2020/21,Liverpool,2,2,0,0,3,0,3,6
UEFA Champions League - Group D 2020/21,Atalanta,2,1,1,0,6,2,4,4
UEFA Champions League - Group D 2020/21,Ajax,2,0,1,1,2,3,-1,1
UEFA Champions League - Group D 2020/21,FC Midtjylland,2,0,0,2,0,6,-6,0
UEFA Champions League - Group E 2020/21,Chelsea,2,1,1,0,4,0,4,4
UEFA Champions League - Group E 2020/21,Sevilla,2,1,1,0,1,0,1,4
UEFA Champions League - Group E 2020/21,Krasnodar,2,0,1,1,1,5,-4,1
UEFA Champions League - Group E 2020/21,Rennes,2,0,1,1,1,2,-1,1
UEFA Champions League - Group F 2020/21,Lazio,2,1,1,0,4,2,2,4
UEFA Champions League - Group F 2020/21,Club Brugge,2,1,1,0,3,2,1,4
UEFA Champions League - Group F 2020/21,Borussia Dortmund,2,1,0,1,3,3,0,3
UEFA Champions League - Group F 2020/21,Zenit St. Petersburg,2,0,0,2,1,4,-3,0
UEFA Champions League - Group G 2020/21,Barcelona,2,2,0,0,7,1,6,6
UEFA Champions League - Group G 2020/21,Juventus,2,1,0,1,2,2,0,3
UEFA Champions League - Group G 2020/21,Dynamo Kiev,2,0,1,1,2,4,-2,1
UEFA Champions League - Group G 2020/21,Ferencvaros,2,0,1,1,3,7,-4,1
UEFA Champions League - Group H 2020/21,Manchester United,2,2,0,0,7,1,6,6
UEFA Champions League - Group H 2020/21,Paris Saint-Germain,2,1,0,1,3,2,1,3
UEFA Champions League - Group H 2020/21,RB Leipzig,2,1,0,1,2,5,-3,3
UEFA Champions League - Group H 2020/21,Istanbul Buyuksehir,2,0,0,2,0,4,-4,0
Coca-Cola Football League Championship 2009/10,Newcastle United,46,30,12,4,90,35,55,102
Coca-Cola Football League Championship 2009/10,West Bromwich Albion,46,26,13,7,89,48,41,91
Coca-Cola Football League Championship 2009/10,Nottingham Forest,46,22,13,11,65,40,25,79
Coca-Cola Football League Championship 2009/10,Cardiff City,46,22,10,14,73,54,19,76
Coca-Cola Football League Championship 2009/10,Leicester City,46,21,13,12,61,45,16,76
Coca-Cola Football League Championship 2009/10,Blackpool,46,19,13,14,74,58,16,70
Coca-Cola Football League Championship 2009/10,Swansea City,46,17,18,11,40,37,3,69
Coca-Cola Football League Championship 2009/10,Sheffield United,46,17,14,15,62,55,7,65
Coca-Cola Football League Championship 2009/10,Reading,46,17,12,17,68,63,5,63
Coca-Cola Football League Championship 2009/10,Bristol City,46,15,18,13,56,65,-9,63
Coca-Cola Football League Championship 2009/10,Middlesbrough,46,16,14,16,58,50,8,62
Coca-Cola Football League Championship 2009/10,Doncaster Rovers,46,15,15,16,59,58,1,60
Coca-Cola Football League Championship 2009/10,Queens Park Rangers,46,14,15,17,58,65,-7,57
Coca-Cola Football League Championship 2009/10,Derby County,46,15,11,20,53,63,-10,56
Coca-Cola Football League Championship 2009/10,Ipswich Town,46,12,20,14,50,61,-11,56
Coca-Cola Football League Championship 2009/10,Watford,46,14,12,20,61,68,-7,54
Coca-Cola Football League Championship 2009/10,Preston North End,46,13,15,18,58,73,-15,54
Coca-Cola Football League Championship 2009/10,Barnsley,46,14,12,20,53,69,-16,54
Coca-Cola Football League Championship 2009/10,Coventry City,46,13,15,18,47,64,-17,54
Coca-Cola Football League Championship 2009/10,Scunthorpe United,46,14,10,22,62,84,-22,52
Coca-Cola Football League Championship 2009/10,Crystal Palace *,46,14,17,15,50,53,-3,49
Coca-Cola Football League Championship 2009/10,Sheffield Wednesday,46,11,14,21,49,69,-20,47
Coca-Cola Football League Championship 2009/10,Plymouth Argyle,46,11,8,27,43,68,-25,41
Coca-Cola Football League Championship 2009/10,Peterborough United,46,8,10,28,46,80,-34,34
npower Championship 2010/11,Queens Park Rangers,46,24,16,6,71,32,39,88
npower Championship 2010/11,Norwich City,46,23,15,8,83,58,25,84
npower Championship 2010/11,Swansea City,46,24,8,14,69,42,27,80
npower Championship 2010/11,Cardiff City,46,23,11,12,76,54,22,80
npower Championship 2010/11,Reading,46,20,17,9,77,51,26,77
npower Championship 2010/11,Nottingham Forest,46,20,15,11,69,50,19,75
npower Championship 2010/11,Leeds United,46,19,15,12,81,70,11,72
npower Championship 2010/11,Burnley,46,18,14,14,65,61,4,68
npower Championship 2010/11,Millwall,46,18,13,15,62,48,14,67
npower Championship 2010/11,Leicester City,46,19,10,17,76,71,5,67
npower Championship 2010/11,Hull City,46,16,17,13,52,51,1,65
npower Championship 2010/11,Middlesbrough,46,17,11,18,68,68,0,62
npower Championship 2010/11,Ipswich Town,46,18,8,20,62,68,-6,62
npower Championship 2010/11,Watford,46,16,13,17,77,71,6,61
npower Championship 2010/11,Bristol City,46,17,9,20,62,65,-3,60
npower Championship 2010/11,Portsmouth,46,15,13,18,53,60,-7,58
npower Championship 2010/11,Barnsley,46,14,14,18,55,66,-11,56
npower Championship 2010/11,Coventry City,46,14,13,19,54,58,-4,55
npower Championship 2010/11,Derby County,46,13,10,23,58,71,-13,49
npower Championship 2010/11,Crystal Palace,46,12,12,22,44,69,-25,48
npower Championship 2010/11,Doncaster Rovers,46,11,15,20,55,81,-26,48
npower Championship 2010/11,Preston North End,46,10,12,24,54,79,-25,42
npower Championship 2010/11,Sheffield United,46,11,9,26,44,79,-35,42
npower Championship 2010/11,Scunthorpe United,46,12,6,28,43,87,-44,42
npower Championship 2011/12,Reading,46,27,8,11,69,41,28,89
npower Championship 2011/12,Southampton,46,26,10,10,85,46,39,88
npower Championship 2011/12,West Ham United,46,24,14,8,81,48,33,86
npower Championship 2011/12,Birmingham City,46,20,16,10,78,51,27,76
npower Championship 2011/12,Blackpool,46,20,15,11,79,59,20,75
npower Championship 2011/12,Cardiff City,46,19,18,9,66,53,13,75
npower Championship 2011/12,Middlesbrough,46,18,16,12,52,51,1,70
npower Championship 2011/12,Hull City,46,19,11,16,47,44,3,68
npower Championship 2011/12,Leicester City,46,18,12,16,66,55,11,66
npower Championship 2011/12,Brighton and Hove Albion,46,17,15,14,52,52,0,66
npower Championship 2011/12,Watford,46,16,16,14,56,64,-8,64
npower Championship 2011/12,Derby County,46,18,10,18,50,58,-8,64
npower Championship 2011/12,Burnley,46,17,11,18,61,58,3,62
npower Championship 2011/12,Leeds United,46,17,10,19,65,68,-3,61
npower Championship 2011/12,Ipswich Town,46,17,10,19,69,77,-8,61
npower Championship 2011/12,Millwall,46,15,12,19,55,57,-2,57
npower Championship 2011/12,Crystal Palace,46,13,17,16,46,51,-5,56
npower Championship 2011/12,Peterborough United,46,13,11,22,67,77,-10,50
npower Championship 2011/12,Nottingham Forest,46,14,8,24,48,63,-15,50
npower Championship 2011/12,Bristol City,46,12,13,21,44,68,-24,49
npower Championship 2011/12,Barnsley,46,13,9,24,49,74,-25,48
npower Championship 2011/12,Portsmouth *,46,13,11,22,50,59,-9,40
npower Championship 2011/12,Coventry City,46,9,13,24,41,65,-24,40
npower Championship 2011/12,Doncaster Rovers,46,8,12,26,43,80,-37,36
npower Championship 2012/13,Cardiff City,46,25,12,9,72,45,27,87
npower Championship 2012/13,Hull City,46,24,7,15,61,52,9,79
npower Championship 2012/13,Watford,46,23,8,15,85,58,27,77
npower Championship 2012/13,Brighton and Hove Albion,46,19,18,9,69,43,26,75
npower Championship 2012/13,Crystal Palace,46,19,15,12,73,62,11,72
npower Championship 2012/13,Leicester City,46,19,11,16,71,48,23,68
npower Championship 2012/13,Bolton Wanderers,46,18,14,14,69,61,8,68
npower Championship 2012/13,Nottingham Forest,46,17,16,13,63,59,4,67
npower Championship 2012/13,Charlton Athletic,46,17,14,15,65,59,6,65
npower Championship 2012/13,Derby County,46,16,13,17,65,62,3,61
npower Championship 2012/13,Burnley,46,16,13,17,62,60,2,61
npower Championship 2012/13,Birmingham City,46,15,16,15,63,69,-6,61
npower Championship 2012/13,Leeds United,46,17,10,19,57,66,-9,61
npower Championship 2012/13,Ipswich Town,46,16,12,18,48,61,-13,60
npower Championship 2012/13,Blackpool,46,14,17,15,62,63,-1,59
npower Championship 2012/13,Middlesbrough,46,18,5,23,61,70,-9,59
npower Championship 2012/13,Blackburn Rovers,46,14,16,16,55,62,-7,58
npower Championship 2012/13,Sheffield Wednesday,46,16,10,20,53,61,-8,58
npower Championship 2012/13,Huddersfield Town,46,15,13,18,53,73,-20,58
npower Championship 2012/13,Millwall,46,15,11,20,51,62,-11,56
npower Championship 2012/13,Barnsley,46,14,13,19,56,70,-14,55
npower Championship 2012/13,Peterborough United,46,15,9,22,66,75,-9,54
npower Championship 2012/13,Wolverhampton Wanderers,46,14,9,23,55,69,-14,51
npower Championship 2012/13,Bristol City,46,11,8,27,59,84,-25,41
Sky Bet Championship 2013/14,Leicester City,46,31,9,6,83,43,40,102
Sky Bet Championship 2013/14,Burnley,46,26,15,5,72,37,35,93
Sky Bet Championship 2013/14,Derby County,46,25,10,11,84,52,32,85
Sky Bet Championship 2013/14,Queens Park Rangers,46,23,11,12,60,44,16,80
Sky Bet Championship 2013/14,Wigan Athletic,46,21,10,15,61,48,13,73
Sky Bet Championship 2013/14,Brighton and Hove Albion,46,19,15,12,55,40,15,72
Sky Bet Championship 2013/14,Reading,46,19,14,13,70,56,14,71
Sky Bet Championship 2013/14,Blackburn Rovers,46,18,16,12,70,62,8,70
Sky Bet Championship 2013/14,Ipswich Town,46,18,14,14,60,54,6,68
Sky Bet Championship 2013/14,Bournemouth,46,18,12,16,67,66,1,66
Sky Bet Championship 2013/14,Nottingham Forest,46,16,17,13,67,64,3,65
Sky Bet Championship 2013/14,Middlesbrough,46,16,16,14,62,50,12,64
Sky Bet Championship 2013/14,Watford,46,15,15,16,74,64,10,60
Sky Bet Championship 2013/14,Bolton Wanderers,46,14,17,15,59,60,-1,59
Sky Bet Championship 2013/14,Leeds United,46,16,9,21,59,67,-8,57
Sky Bet Championship 2013/14,Sheffield Wednesday,46,13,14,19,63,65,-2,53
Sky Bet Championship 2013/14,Huddersfield Town,46,14,11,21,58,65,-7,53
Sky Bet Championship 2013/14,Charlton Athletic,46,13,12,21,41,61,-20,51
Sky Bet Championship 2013/14,Millwall,46,11,15,20,46,74,-28,48
Sky Bet Championship 2013/14,Blackpool,46,11,13,22,38,66,-28,46
Sky Bet Championship 2013/14,Birmingham City,46,11,11,24,58,74,-16,44
Sky Bet Championship 2013/14,Doncaster Rovers,46,11,11,24,39,70,-31,44
Sky Bet Championship 2013/14,Barnsley,46,9,12,25,44,77,-33,39
Sky Bet Championship 2013/14,Yeovil Town,46,8,13,25,44,75,-31,37
Sky Bet Championship 2014/15,Bournemouth,46,26,12,8,98,45,53,90
Sky Bet Championship 2014/15,Watford,46,27,8,11,91,50,41,89
Sky Bet Championship 2014/15,Norwich City,46,25,11,10,88,48,40,86
Sky Bet Championship 2014/15,Middlesbrough,46,25,10,11,68,37,31,85
Sky Bet Championship 2014/15,Brentford,46,23,9,14,78,59,19,78
Sky Bet Championship 2014/15,Ipswich Town,46,22,12,12,72,54,18,78
Sky Bet Championship 2014/15,Wolverhampton Wanderers,46,22,12,12,70,56,14,78
Sky Bet Championship 2014/15,Derby County,46,21,14,11,85,56,29,77
Sky Bet Championship 2014/15,Blackburn Rovers,46,17,16,13,66,59,7,67
Sky Bet Championship 2014/15,Birmingham City,46,16,15,15,54,64,-10,63
Sky Bet Championship 2014/15,Cardiff City,46,16,14,16,57,61,-4,62
Sky Bet Championship 2014/15,Charlton Athletic,46,14,18,14,54,60,-6,60
Sky Bet Championship 2014/15,Sheffield Wednesday,46,14,18,14,43,49,-6,60
Sky Bet Championship 2014/15,Nottingham Forest,46,15,14,17,71,69,2,59
Sky Bet Championship 2014/15,Leeds United,46,15,11,20,50,61,-11,56
Sky Bet Championship 2014/15,Huddersfield Town,46,13,16,17,58,75,-17,55
Sky Bet Championship 2014/15,Fulham,46,14,10,22,62,83,-21,52
Sky Bet Championship 2014/15,Bolton Wanderers,46,13,12,21,54,67,-13,51
Sky Bet Championship 2014/15,Reading,46,13,11,22,48,69,-21,50
Sky Bet Championship 2014/15,Brighton and Hove Albion,46,10,17,19,44,54,-10,47
Sky Bet Championship 2014/15,Rotherham United *,46,11,16,19,46,67,-21,46
Sky Bet Championship 2014/15,Millwall,46,9,14,23,42,76,-34,41
Sky Bet Championship 2014/15,Wigan Athletic,46,9,12,25,39,64,-25,39
Sky Bet Championship 2014/15,Blackpool,46,4,14,28,36,91,-55,26
Sky Bet Championship 2015/16,Burnley,46,26,15,5,72,35,37,93
Sky Bet Championship 2015/16,Middlesbrough,46,26,11,9,63,31,32,89
Sky Bet Championship 2015/16,Brighton and Hove Albion,46,24,17,5,72,42,30,89
Sky Bet Championship 2015/16,Hull City,46,24,11,11,69,35,34,83
Sky Bet Championship 2015/16,Derby County,46,21,15,10,66,43,23,78
Sky Bet Championship 2015/16,Sheffield Wednesday,46,19,17,10,66,45,21,74
Sky Bet Championship 2015/16,Ipswich Town,46,18,15,13,53,51,2,69
Sky Bet Championship 2015/16,Cardiff City,46,17,17,12,56,51,5,68
Sky Bet Championship 2015/16,Brentford,46,19,8,19,72,67,5,65
Sky Bet Championship 2015/16,Birmingham City,46,16,15,15,53,49,4,63
Sky Bet Championship 2015/16,Preston North End,46,15,17,14,45,45,0,62
Sky Bet Championship 2015/16,Queens Park Rangers,46,14,18,14,54,54,0,60
Sky Bet Championship 2015/16,Leeds United,46,14,17,15,50,58,-8,59
Sky Bet Championship 2015/16,Wolverhampton Wanderers,46,14,16,16,53,58,-5,58
Sky Bet Championship 2015/16,Blackburn Rovers,46,13,16,17,46,46,0,55
Sky Bet Championship 2015/16,Nottingham Forest,46,13,16,17,43,47,-4,55
Sky Bet Championship 2015/16,Reading,46,13,13,20,52,59,-7,52
Sky Bet Championship 2015/16,Bristol City,46,13,13,20,54,71,-17,52
Sky Bet Championship 2015/16,Huddersfield Town,46,13,12,21,59,70,-11,51
Sky Bet Championship 2015/16,Fulham,46,12,15,19,66,79,-13,51
Sky Bet Championship 2015/16,Rotherham United,46,13,10,23,53,71,-18,49
Sky Bet Championship 2015/16,Charlton Athletic,46,9,13,24,40,80,-40,40
Sky Bet Championship 2015/16,Milton Keynes Dons,46,9,12,25,39,69,-30,39
Sky Bet Championship 2015/16,Bolton Wanderers,46,5,15,26,41,81,-40,30
Sky Bet Championship 2016/17,Newcastle United,46,29,7,10,85,40,45,94
Sky Bet Championship 2016/17,Brighton and Hove Albion,46,28,9,9,74,40,34,93
Sky Bet Championship 2016/17,Reading,46,26,7,13,68,64,4,85
Sky Bet Championship 2016/17,Sheffield Wednesday,46,24,9,13,60,45,15,81
Sky Bet Championship 2016/17,Huddersfield Town,46,25,6,15,56,58,-2,81
Sky Bet Championship 2016/17,Fulham,46,22,14,10,85,57,28,80
Sky Bet Championship 2016/17,Leeds United,46,22,9,15,61,47,14,75
Sky Bet Championship 2016/17,Norwich City,46,20,10,16,85,69,16,70
Sky Bet Championship 2016/17,Derby County,46,18,13,15,54,50,4,67
Sky Bet Championship 2016/17,Brentford,46,18,10,18,75,65,10,64
Sky Bet Championship 2016/17,Preston North End,46,16,14,16,64,63,1,62
Sky Bet Championship 2016/17,Cardiff City,46,17,11,18,60,61,-1,62
Sky Bet Championship 2016/17,Aston Villa,46,16,14,16,47,48,-1,62
Sky Bet Championship 2016/17,Barnsley,46,15,13,18,64,67,-3,58
Sky Bet Championship 2016/17,Wolverhampton Wanderers,46,16,10,20,54,58,-4,58
Sky Bet Championship 2016/17,Ipswich Town,46,13,16,17,48,58,-10,55
Sky Bet Championship 2016/17,Bristol City,46,15,9,22,60,66,-6,54
Sky Bet Championship 2016/17,Queens Park Rangers,46,15,8,23,52,66,-14,53
Sky Bet Championship 2016/17,Birmingham City,46,13,14,19,45,64,-19,53
Sky Bet Championship 2016/17,Burton Albion,46,13,13,20,49,63,-14,52
Sky Bet Championship 2016/17,Nottingham Forest,46,14,9,23,62,72,-10,51
Sky Bet Championship 2016/17,Blackburn Rovers,46,12,15,19,53,65,-12,51
Sky Bet Championship 2016/17,Wigan Athletic,46,10,12,24,40,57,-17,42
Sky Bet Championship 2016/17,Rotherham United,46,5,8,33,40,98,-58,23
Sky Bet Championship 2017/18,Wolverhampton Wanderers,46,30,9,7,82,39,43,99
Sky Bet Championship 2017/18,Cardiff City,46,27,9,10,69,39,30,90
Sky Bet Championship 2017/18,Fulham,46,25,13,8,79,46,33,88
Sky Bet Championship 2017/18,Aston Villa,46,24,11,11,72,42,30,83
Sky Bet Championship 2017/18,Middlesbrough,46,22,10,14,67,45,22,76
Sky Bet Championship 2017/18,Derby County,46,20,15,11,70,48,22,75
Sky Bet Championship 2017/18,Preston North End,46,19,16,11,57,46,11,73
Sky Bet Championship 2017/18,Millwall,46,19,15,12,56,45,11,72
Sky Bet Championship 2017/18,Brentford,46,18,15,13,62,52,10,69
Sky Bet Championship 2017/18,Sheffield United,46,20,9,17,62,55,7,69
Sky Bet Championship 2017/18,Bristol City,46,17,16,13,67,58,9,67
Sky Bet Championship 2017/18,Ipswich Town,46,17,9,20,57,60,-3,60
Sky Bet Championship 2017/18,Leeds United,46,17,9,20,59,64,-5,60
Sky Bet Championship 2017/18,Norwich City,46,15,15,16,49,60,-11,60
Sky Bet Championship 2017/18,Sheffield Wednesday,46,14,15,17,59,60,-1,57
Sky Bet Championship 2017/18,Queens Park Rangers,46,15,11,20,58,70,-12,56
Sky Bet Championship 2017/18,Nottingham Forest,46,15,8,23,51,65,-14,53
Sky Bet Championship 2017/18,Hull City,46,11,16,19,70,70,0,49
Sky Bet Championship 2017/18,Birmingham City,46,13,7,26,38,68,-30,46
Sky Bet Championship 2017/18,Reading,46,10,14,22,48,70,-22,44
Sky Bet Championship 2017/18,Bolton Wanderers,46,10,13,23,39,74,-35,43
Sky Bet Championship 2017/18,Barnsley,46,9,14,23,48,72,-24,41
Sky Bet Championship 2017/18,Burton Albion,46,10,11,25,38,81,-43,41
Sky Bet Championship 2017/18,Sunderland,46,7,16,23,52,80,-28,37
Sky Bet Championship 2018/19,Norwich City,46,27,13,6,93,57,36,94
Sky Bet Championship 2018/19,Sheffield United,46,26,11,9,78,41,37,89
Sky Bet Championship 2018/19,Leeds United,46,25,8,13,73,50,23,83
Sky Bet Championship 2018/19,West Bromwich Albion,46,23,11,12,87,62,25,80
Sky Bet Championship 2018/19,Aston Villa,46,20,16,10,82,61,21,76
Sky Bet Championship 2018/19,Derby County,46,20,14,12,69,54,15,74
Sky Bet Championship 2018/19,Middlesbrough,46,20,13,13,49,41,8,73
Sky Bet Championship 2018/19,Bristol City,46,19,13,14,59,53,6,70
Sky Bet Championship 2018/19,Nottingham Forest,46,17,15,14,61,54,7,66
Sky Bet Championship 2018/19,Swansea City,46,18,11,17,65,62,3,65
Sky Bet Championship 2018/19,Brentford,46,17,13,16,73,59,14,64
Sky Bet Championship 2018/19,Sheffield Wednesday,46,16,16,14,60,62,-2,64
Sky Bet Championship 2018/19,Hull City,46,17,11,18,66,68,-2,62
Sky Bet Championship 2018/19,Preston North End,46,16,13,17,67,67,0,61
Sky Bet Championship 2018/19,Blackburn Rovers,46,16,12,18,64,69,-5,60
Sky Bet Championship 2018/19,Stoke City,46,11,22,13,45,52,-7,55
Sky Bet Championship 2018/19,Birmingham City *,46,14,19,13,64,58,6,52
Sky Bet Championship 2018/19,Wigan Athletic,46,13,13,20,51,64,-13,52
Sky Bet Championship 2018/19,Queens Park Rangers,46,14,9,23,53,71,-18,51
Sky Bet Championship 2018/19,Reading,46,10,17,19,49,66,-17,47
Sky Bet Championship 2018/19,Millwall,46,10,14,22,48,64,-16,44
Sky Bet Championship 2018/19,Rotherham United,46,8,16,22,52,83,-31,40
Sky Bet Championship 2018/19,Bolton Wanderers,46,8,8,30,29,78,-49,32
Sky Bet Championship 2018/19,Ipswich Town,46,5,16,25,36,77,-41,31
Sky Bet Championship 2019/20,Leeds United,46,28,9,9,77,35,42,93
Sky Bet Championship 2019/20,West Bromwich Albion,46,22,17,7,77,45,32,83
Sky Bet Championship 2019/20,Brentford,46,24,9,13,80,38,42,81
Sky Bet Championship 2019/20,Fulham,46,23,12,11,64,48,16,81
Sky Bet Championship 2019/20,Cardiff City,46,19,16,11,68,58,10,73
Sky Bet Championship 2019/20,Swansea City,46,18,16,12,62,53,9,70
Sky Bet Championship 2019/20,Nottingham Forest,46,18,16,12,58,50,8,70
Sky Bet Championship 2019/20,Millwall,46,17,17,12,57,51,6,68
Sky Bet Championship 2019/20,Preston North End,46,18,12,16,59,54,5,66
Sky Bet Championship 2019/20,Derby County,46,17,13,16,62,64,-2,64
Sky Bet Championship 2019/20,Blackburn Rovers,46,17,12,17,66,63,3,63
Sky Bet Championship 2019/20,Bristol City,46,17,12,17,60,65,-5,63
Sky Bet Championship 2019/20,Queens Park Rangers,46,16,10,20,67,76,-9,58
Sky Bet Championship 2019/20,Reading,46,15,11,20,59,58,1,56
Sky Bet Championship 2019/20,Stoke City,46,16,8,22,62,68,-6,56
Sky Bet Championship 2019/20,Sheffield Wednesday,46,15,11,20,58,66,-8,56
Sky Bet Championship 2019/20,Middlesbrough,46,13,14,19,48,61,-13,53
Sky Bet Championship 2019/20,Huddersfield Town,46,13,12,21,52,70,-18,51
Sky Bet Championship 2019/20,Luton Town,46,14,9,23,54,82,-28,51
Sky Bet Championship 2019/20,Birmingham City,46,12,14,20,54,75,-21,50
Sky Bet Championship 2019/20,Barnsley,46,12,13,21,49,69,-20,49
Sky Bet Championship 2019/20,Charlton Athletic,46,12,12,22,50,65,-15,48
Sky Bet Championship 2019/20,Wigan Athletic *,46,15,14,17,57,56,1,47
Sky Bet Championship 2019/20,Hull City,46,12,9,25,57,87,-30,45
Sky Bet Championship 2020/21,Reading,9,7,1,1,17,6,11,22
Sky Bet Championship 2020/21,Swansea City,9,5,3,1,12,5,7,18
Sky Bet Championship 2020/21,Bournemouth,9,4,5,0,12,7,5,17
Sky Bet Championship 2020/21,Norwich City,9,5,2,2,12,8,4,17
Sky Bet Championship 2020/21,Middlesbrough,9,4,4,1,9,5,4,16
Sky Bet Championship 2020/21,Watford,9,4,3,2,8,5,3,15
Sky Bet Championship 2020/21,Millwall,9,4,3,2,10,8,2,15
Sky Bet Championship 2020/21,Stoke City,9,4,3,2,10,9,1,15
Sky Bet Championship 2020/21,Brentford,9,4,2,3,16,11,5,14
Sky Bet Championship 2020/21,Bristol City,9,4,2,3,12,10,2,14
Sky Bet Championship 2020/21,Birmingham City,9,3,4,2,7,6,1,13
Sky Bet Championship 2020/21,Huddersfield Town,9,4,1,4,10,10,0,13
Sky Bet Championship 2020/21,Luton Town,9,4,1,4,7,10,-3,13
Sky Bet Championship 2020/21,Blackburn Rovers,9,3,1,5,18,13,5,10
Sky Bet Championship 2020/21,Barnsley,9,2,4,3,10,10,0,10
Sky Bet Championship 2020/21,Preston North End,9,3,1,5,11,12,-1,10
Sky Bet Championship 2020/21,Cardiff City,9,2,4,3,9,10,-1,10
Sky Bet Championship 2020/21,Queens Park Rangers,9,2,4,3,9,12,-3,10
Sky Bet Championship 2020/21,Rotherham United,9,2,3,4,8,10,-2,9
Sky Bet Championship 2020/21,Coventry City,9,2,2,5,9,18,-9,8
Sky Bet Championship 2020/21,Nottingham Forest,9,1,3,5,5,11,-6,6
Sky Bet Championship 2020/21,Derby County,9,1,3,5,5,13,-8,6
Sky Bet Championship 2020/21,Wycombe Wanderers,9,1,1,7,4,16,-12,4
Sky Bet Championship 2020/21,Sheffield Wednesday *,9,2,2,5,5,10,-5,-4
Chinese Super League 2016/17,Guangzhou Evergrande,30,19,7,4,62,19,43,64
Chinese Super League 2016/17,Jiangsu Suning FC,30,17,6,7,53,33,20,57
Chinese Super League 2016/17,Shanghai SIPG,30,14,10,6,56,32,24,52
Chinese Super League 2016/17,Shanghai Shenhua,30,12,12,6,46,31,15,48
Chinese Super League 2016/17,Beijing Guoan,30,11,10,9,34,26,8,43
Chinese Super League 2016/17,Guangzhou R&F,30,11,7,12,47,50,-3,40
Chinese Super League 2016/17,Hebei China Fortune FC,30,11,7,12,34,38,-4,40
Chinese Super League 2016/17,Chongqing Lifan,30,9,10,11,43,50,-7,37
Chinese Super League 2016/17,Yanbian Fude FC,30,10,7,13,39,41,-2,37
Chinese Super League 2016/17,Tianjin Teda,30,9,9,12,38,50,-12,36
Chinese Super League 2016/17,Liaoning Whowin,30,9,9,12,38,47,-9,36
Chinese Super League 2016/17,Changchun Yatai,30,10,5,15,30,44,-14,35
Chinese Super League 2016/17,Henan Jianye,30,10,5,15,26,44,-18,35
Chinese Super League 2016/17,Shandong Luneng,30,9,7,14,38,45,-7,34
Chinese Super League 2016/17,Hangzhou Greentown,30,8,8,14,28,37,-9,32
Chinese Super League 2016/17,Shijiazhuang Ever Bright,30,7,9,14,28,53,-25,30
Chinese Super League 2017/18,Guangzhou Evergrande,30,20,4,6,69,42,27,64
Chinese Super League 2017/18,Shanghai SIPG,30,17,7,6,72,39,33,58
Chinese Super League 2017/18,Tianjin Quanjian,30,15,9,6,46,33,13,54
Chinese Super League 2017/18,Hebei China Fortune FC,30,15,7,8,55,38,17,52
Chinese Super League 2017/18,Guangzhou R&F,30,15,7,8,59,46,13,52
Chinese Super League 2017/18,Shandong Luneng,30,13,10,7,49,33,16,49
Chinese Super League 2017/18,Changchun Yatai,30,12,8,10,46,41,5,44
Chinese Super League 2017/18,Guizhou Hengfeng Zhicheng,30,12,6,12,39,45,-6,42
Chinese Super League 2017/18,Beijing Guoan,30,11,7,12,42,42,0,40
Chinese Super League 2017/18,Chongqing Lifan,30,9,9,12,37,40,-3,36
Chinese Super League 2017/18,Shanghai Shenhua,30,9,8,13,52,55,-3,35
Chinese Super League 2017/18,Jiangsu Suning FC,30,7,11,12,40,45,-5,32
Chinese Super League 2017/18,Tianjin Teda,30,8,7,15,30,49,-19,31
Chinese Super League 2017/18,Henan Jianye,30,7,9,14,34,46,-12,30
Chinese Super League 2017/18,Yanbian Fude FC,30,5,7,18,32,64,-32,22
Chinese Super League 2017/18,Liaoning Whowin,30,4,6,20,30,74,-44,18
Chinese Super League 2018/19,Shanghai SIPG,30,21,5,4,77,33,44,68
Chinese Super League 2018/19,Guangzhou Evergrande,30,20,3,7,82,36,46,63
Chinese Super League 2018/19,Shandong Luneng,30,17,7,6,57,39,18,58
Chinese Super League 2018/19,Beijing Guoan,30,15,8,7,64,45,19,53
Chinese Super League 2018/19,Jiangsu Suning FC,30,13,9,8,48,33,15,48
Chinese Super League 2018/19,Hebei China Fortune FC,30,10,9,11,46,50,-4,39
Chinese Super League 2018/19,Shanghai Shenhua,30,10,8,12,44,53,-9,38
Chinese Super League 2018/19,Beijing Renhe,30,9,10,11,33,46,-13,37
Chinese Super League 2018/19,Tianjin Quanjian,30,9,9,12,41,48,-7,36
Chinese Super League 2018/19,Guangzhou R&F,30,10,6,14,49,61,-12,36
Chinese Super League 2018/19,Dalian Yifang,30,10,5,15,37,57,-20,35
Chinese Super League 2018/19,Henan Jianye,30,10,4,16,30,45,-15,34
Chinese Super League 2018/19,Chongqing Lifan,30,8,8,14,40,46,-6,32
Chinese Super League 2018/19,Tianjin Teda,30,8,8,14,41,54,-13,32
Chinese Super League 2018/19,Changchun Yatai,30,8,8,14,45,56,-11,32
Chinese Super League 2018/19,Guizhou Hengfeng Zhicheng,30,7,3,20,34,66,-32,24
Chinese Super League 2019/20,Guangzhou Evergrande,30,23,3,4,68,24,44,72
Chinese Super League 2019/20,Beijing Guoan,30,23,1,6,60,26,34,70
Chinese Super League 2019/20,Shanghai SIPG,30,20,6,4,62,26,36,66
Chinese Super League 2019/20,Jiangsu Suning FC,30,15,8,7,60,41,19,53
Chinese Super League 2019/20,Shandong Luneng,30,15,6,9,55,35,20,51
Chinese Super League 2019/20,Wuhan Zall,30,12,8,10,41,41,0,44
Chinese Super League 2019/20,Tianjin Teda,30,12,5,13,43,45,-2,41
Chinese Super League 2019/20,Henan Jianye,30,11,8,11,41,46,-5,41
Chinese Super League 2019/20,Dalian Yifang,30,10,8,12,44,51,-7,38
Chinese Super League 2019/20,Chongqing Lifan,30,9,9,12,36,47,-11,36
Chinese Super League 2019/20,Hebei China Fortune FC,30,9,6,15,37,55,-18,33
Chinese Super League 2019/20,Guangzhou R&F,30,9,5,16,54,72,-18,32
Chinese Super League 2019/20,Shanghai Shenhua,30,8,6,16,43,57,-14,30
Chinese Super League 2019/20,Tianjin Quanjian,30,4,13,13,40,53,-13,25
Chinese Super League 2019/20,Shenzen,30,4,9,17,31,57,-26,21
Chinese Super League 2019/20,Beijing Renhe,30,3,5,22,26,65,-39,14
Chinese Super League 2020/21,Shanghai SIPG,14,10,2,2,26,11,15,32
Chinese Super League 2020/21,Beijing Guoan,14,8,4,2,36,19,17,28
Chinese Super League 2020/21,Chongqing Lifan,14,7,3,4,22,19,3,24
Chinese Super League 2020/21,Hebei China Fortune FC,14,7,3,4,25,23,2,24
Chinese Super League 2020/21,Wuhan Zall,14,5,2,7,16,16,0,17
Chinese Super League 2020/21,Shijiazhuang Ever Bright,14,4,5,5,18,21,-3,17
Chinese Super League 2020/21,Qingdao Huanghai,14,2,4,8,15,27,-12,10
Chinese Super League 2020/21,Tianjin Teda,14,0,3,11,8,30,-22,3
Copa America - Group A 2015/16,Chile,3,2,1,0,10,3,7,7
Copa America - Group A 2015/16,Bolivia,3,1,1,1,3,7,-4,4
Copa America - Group A 2015/16,Ecuador,3,1,0,2,4,6,-2,3
Copa America - Group A 2015/16,Mexico,3,0,2,1,4,5,-1,2
Copa America - Group B 2015/16,Argentina,3,2,1,0,4,2,2,7
Copa America - Group B 2015/16,Paraguay,3,1,2,0,4,3,1,5
Copa America - Group B 2015/16,Uruguay,3,1,1,1,2,2,0,4
Copa America - Group B 2015/16,Jamaica,3,0,0,3,0,3,-3,0
Copa America - Group C 2015/16,Brazil,3,2,0,1,4,3,1,6
Copa America - Group C 2015/16,Peru,3,1,1,1,2,2,0,4
Copa America - Group C 2015/16,Colombia,3,1,1,1,1,1,0,4
Copa America - Group C 2015/16,Venezuela,3,1,0,2,2,3,-1,3
Copa America - Group A 2016/17,United States of America,3,2,0,1,5,2,3,6
Copa America - Group A 2016/17,Colombia,3,2,0,1,6,4,2,6
Copa America - Group A 2016/17,Costa Rica,3,1,1,1,3,6,-3,4
Copa America - Group A 2016/17,Paraguay,3,0,1,2,1,3,-2,1
Copa America - Group B 2016/17,Peru,3,2,1,0,4,2,2,7
Copa America - Group B 2016/17,Ecuador,3,1,2,0,6,2,4,5
Copa America - Group B 2016/17,Brazil,3,1,1,1,7,2,5,4
Copa America - Group B 2016/17,Haiti,3,0,0,3,1,12,-11,0
Copa America - Group C 2016/17,Mexico,3,2,1,0,6,2,4,7
Copa America - Group C 2016/17,Venezuela,3,2,1,0,3,1,2,7
Copa America - Group C 2016/17,Uruguay,3,1,0,2,4,4,0,3
Copa America - Group C 2016/17,Jamaica,3,0,0,3,0,6,-6,0
Copa America - Group D 2016/17,Argentina,3,3,0,0,10,1,9,9
Copa America - Group D 2016/17,Chile,3,2,0,1,7,5,2,6
Copa America - Group D 2016/17,Panama,3,1,0,2,4,10,-6,3
Copa America - Group D 2016/17,Bolivia,3,0,0,3,2,7,-5,0
Copa America - Group A 2018/19,Brazil,0,0,0,0,0,0,0,0
Copa America - Group A 2018/19,Peru,0,0,0,0,0,0,0,0
Copa America - Group A 2018/19,Venezuela,0,0,0,0,0,0,0,0
Copa America - Group A 2018/19,Bolivia,0,0,0,0,0,0,0,0
Copa America - Group B 2018/19,Argentina,0,0,0,0,0,0,0,0
Copa America - Group B 2018/19,Colombia,0,0,0,0,0,0,0,0
Copa America - Group B 2018/19,Paraguay,0,0,0,0,0,0,0,0
Copa America - Group B 2018/19,Qatar,0,0,0,0,0,0,0,0
Copa America - Group C 2018/19,Uruguay,0,0,0,0,0,0,0,0
Copa America - Group C 2018/19,Chile,0,0,0,0,0,0,0,0
Copa America - Group C 2018/19,Japan,0,0,0,0,0,0,0,0
Copa America - Group C 2018/19,Ecuador,0,0,0,0,0,0,0,0
Copa America - Group A 2019/20,Brazil,3,2,1,0,8,0,8,7
Copa America - Group A 2019/20,Venezuela,3,1,2,0,3,1,2,5
Copa America - Group A 2019/20,Peru,3,1,1,1,3,6,-3,4
Copa America - Group A 2019/20,Bolivia,3,0,0,3,2,9,-7,0
Copa America - Group B 2019/20,Colombia,3,3,0,0,4,0,4,9
Copa America - Group B 2019/20,Argentina,3,1,1,1,3,3,0,4
Copa America - Group B 2019/20,Paraguay,3,0,2,1,3,4,-1,2
Copa America - Group B 2019/20,Qatar,3,0,1,2,2,5,-3,1
Copa America - Group C 2019/20,Uruguay,3,2,1,0,7,2,5,7
Copa America - Group C 2019/20,Chile,3,2,0,1,6,2,4,6
Copa America - Group C 2019/20,Japan,3,0,2,1,3,7,-4,2
Copa America - Group C 2019/20,Ecuador,3,0,1,2,2,7,-5,1
Leasing.com Trophy - Northern Group A 2016/17,Cheltenham Town,3,2,0,1,4,3,1,6
Leasing.com Trophy - Northern Group A 2016/17,Blackpool,3,1,1,1,3,3,0,5
Leasing.com Trophy - Northern Group A 2016/17,Everton U21,3,1,1,1,4,3,1,4
Leasing.com Trophy - Northern Group A 2016/17,Bolton Wanderers,3,1,0,2,1,3,-2,3
Leasing.com Trophy - Northern Group B 2016/17,Wolverhampton Wanderers U21,3,2,0,1,8,4,4,6
Leasing.com Trophy - Northern Group B 2016/17,Chesterfield,3,2,0,1,5,5,0,6
Leasing.com Trophy - Northern Group B 2016/17,Crewe Alexandra,3,1,0,2,5,5,0,3
Leasing.com Trophy - Northern Group B 2016/17,Accrington Stanley,3,1,0,2,4,8,-4,3
Leasing.com Trophy - Northern Group C 2016/17,Bradford City,3,2,0,1,5,4,1,6
Leasing.com Trophy - Northern Group C 2016/17,Morecambe,3,2,0,1,7,7,0,6
Leasing.com Trophy - Northern Group C 2016/17,Bury,3,1,1,1,6,4,2,4
Leasing.com Trophy - Northern Group C 2016/17,Stoke City U21,3,0,1,2,2,5,-3,2
Leasing.com Trophy - Northern Group D 2016/17,Carlisle United,3,3,0,0,11,6,5,9
Leasing.com Trophy - Northern Group D 2016/17,Oldham Athletic,3,1,1,1,8,7,1,5
Leasing.com Trophy - Northern Group D 2016/17,Fleetwood Town,3,1,0,2,3,6,-3,3
Leasing.com Trophy - Northern Group D 2016/17,Blackburn Rovers U21,3,0,1,2,2,5,-3,1
Leasing.com Trophy - Northern Group E 2016/17,Doncaster Rovers,3,1,2,0,4,2,2,6
Leasing.com Trophy - Northern Group E 2016/17,Mansfield Town,3,2,0,1,4,4,0,6
Leasing.com Trophy - Northern Group E 2016/17,Port Vale,3,1,1,1,1,1,0,5
Leasing.com Trophy - Northern Group E 2016/17,Derby County U21,3,0,1,2,4,6,-2,1
Leasing.com Trophy - Northern Group F 2016/17,Rochdale,3,2,1,0,5,3,2,8
Leasing.com Trophy - Northern Group F 2016/17,Sunderland U21,3,2,1,0,4,2,2,7
Leasing.com Trophy - Northern Group F 2016/17,Notts County,3,1,0,2,4,5,-1,3
Leasing.com Trophy - Northern Group F 2016/17,Hartlepool United,3,0,0,3,2,5,-3,0
Leasing.com Trophy - Northern Group G 2016/17,Scunthorpe United,3,3,0,0,6,1,5,9
Leasing.com Trophy - Northern Group G 2016/17,Cambridge United,3,2,0,1,3,3,0,6
Leasing.com Trophy - Northern Group G 2016/17,Shrewsbury Town,3,1,0,2,3,3,0,3
Leasing.com Trophy - Northern Group G 2016/17,Middlesbrough U21,3,0,0,3,2,7,-5,0
Leasing.com Trophy - Northern Group H 2016/17,Walsall,3,3,0,0,8,3,5,9
Leasing.com Trophy - Northern Group H 2016/17,Leicester City U21,3,1,1,1,1,1,0,5
Leasing.com Trophy - Northern Group H 2016/17,Sheffield United,3,1,1,1,5,4,1,4
Leasing.com Trophy - Northern Group H 2016/17,Grimsby Town,3,0,0,3,4,10,-6,0
Leasing.com Trophy - Southern Group A 2016/17,Yeovil Town,3,2,1,0,6,3,3,7
Leasing.com Trophy - Southern Group A 2016/17,Reading U21,3,1,1,1,5,6,-1,5
Leasing.com Trophy - Southern Group A 2016/17,Portsmouth,3,1,1,1,6,6,0,4
Leasing.com Trophy - Southern Group A 2016/17,Bristol Rovers,3,0,1,2,2,4,-2,2
Leasing.com Trophy - Southern Group B 2016/17,AFC Wimbledon,3,2,0,1,5,3,2,6
Leasing.com Trophy - Southern Group B 2016/17,Swansea City U21,3,2,0,1,4,4,0,6
Leasing.com Trophy - Southern Group B 2016/17,Plymouth Argyle,3,1,0,2,5,5,0,3
Leasing.com Trophy - Southern Group B 2016/17,Newport County AFC,3,1,0,2,4,6,-2,3
Leasing.com Trophy - Southern Group C 2016/17,Swindon Town,3,1,2,0,3,2,1,7
Leasing.com Trophy - Southern Group C 2016/17,Oxford United,3,1,2,0,5,3,2,5
Leasing.com Trophy - Southern Group C 2016/17,Exeter City,3,1,1,1,6,7,-1,4
Leasing.com Trophy - Southern Group C 2016/17,Chelsea U21,3,0,1,2,4,6,-2,2
Leasing.com Trophy - Southern Group D 2016/17,Coventry City,3,3,0,0,11,5,6,9
Leasing.com Trophy - Southern Group D 2016/17,Wycombe Wanderers,3,2,0,1,8,4,4,6
Leasing.com Trophy - Southern Group D 2016/17,West Ham U21,3,0,1,2,3,8,-5,2
Leasing.com Trophy - Southern Group D 2016/17,Northampton Town,3,0,1,2,2,7,-5,1
Leasing.com Trophy - Southern Group E 2016/17,Southampton U21,3,2,1,0,6,1,5,7
Leasing.com Trophy - Southern Group E 2016/17,Crawley Town,3,2,0,1,3,4,-1,6
Leasing.com Trophy - Southern Group E 2016/17,Charlton Athletic,3,0,2,1,1,3,-2,3
Leasing.com Trophy - Southern Group E 2016/17,Colchester United,3,0,1,2,2,4,-2,2
Leasing.com Trophy - Southern Group F 2016/17,Norwich City U21,3,3,0,0,15,2,13,9
Leasing.com Trophy - Southern Group F 2016/17,Milton Keynes Dons,3,1,1,1,4,6,-2,5
Leasing.com Trophy - Southern Group F 2016/17,Peterborough United,3,1,0,2,3,8,-5,3
Leasing.com Trophy - Southern Group F 2016/17,Barnet,3,0,1,2,3,9,-6,1
Leasing.com Trophy - Southern Group G 2016/17,Southend United,3,2,0,1,3,4,-1,6
Leasing.com Trophy - Southern Group G 2016/17,Brighton U21,3,1,1,1,3,4,-1,5
Leasing.com Trophy - Southern Group G 2016/17,Stevenage,3,1,1,1,7,5,2,4
Leasing.com Trophy - Southern Group G 2016/17,Leyton Orient,3,1,0,2,3,3,0,3
Leasing.com Trophy - Southern Group H 2016/17,Millwall,3,3,0,0,7,2,5,9
Leasing.com Trophy - Southern Group H 2016/17,Luton Town,3,2,0,1,5,4,1,6
Leasing.com Trophy - Southern Group H 2016/17,Gillingham,3,1,0,2,4,4,0,3
Leasing.com Trophy - Southern Group H 2016/17,West Bromwich Albion U21,3,0,0,3,0,6,-6,0
Leasing.com Trophy - Northern Group A 2017/18,Fleetwood Town,3,3,0,0,7,2,5,9
Leasing.com Trophy - Northern Group A 2017/18,Leicester City U21,3,1,1,1,3,5,-2,4
Leasing.com Trophy - Northern Group A 2017/18,Carlisle United,3,1,0,2,3,3,0,3
Leasing.com Trophy - Northern Group A 2017/18,Morecambe,3,0,1,2,3,6,-3,2
Leasing.com Trophy - Northern Group B 2017/18,Blackpool,3,2,1,0,7,3,4,7
Leasing.com Trophy - Northern Group B 2017/18,Accrington Stanley,3,2,0,1,8,4,4,6
Leasing.com Trophy - Northern Group B 2017/18,Wigan Athletic,3,1,1,1,5,6,-1,5
Leasing.com Trophy - Northern Group B 2017/18,Middlesbrough U21,3,0,0,3,4,11,-7,0
Leasing.com Trophy - Northern Group C 2017/18,Rochdale,3,1,2,0,5,1,4,6
Leasing.com Trophy - Northern Group C 2017/18,Bury,3,2,0,1,4,5,-1,6
Leasing.com Trophy - Northern Group C 2017/18,Blackburn Rovers,3,1,1,1,2,2,0,4
Leasing.com Trophy - Northern Group C 2017/18,Stoke City U21,3,0,1,2,1,4,-3,2
Leasing.com Trophy - Northern Group D 2017/18,Port Vale,3,2,1,0,5,2,3,8
Leasing.com Trophy - Northern Group D 2017/18,Oldham Athletic,3,2,1,0,5,1,4,7
Leasing.com Trophy - Northern Group D 2017/18,Newcastle United U21,3,1,0,2,3,6,-3,3
Leasing.com Trophy - Northern Group D 2017/18,Crewe Alexandra,3,0,0,3,3,7,-4,0
Leasing.com Trophy - Northern Group E 2017/18,Walsall,3,2,1,0,6,3,3,7
Leasing.com Trophy - Northern Group E 2017/18,Shrewsbury Town,3,2,0,1,6,3,3,6
Leasing.com Trophy - Northern Group E 2017/18,Coventry City,3,1,1,1,6,6,0,5
Leasing.com Trophy - Northern Group E 2017/18,West Bromwich Albion U21,3,0,0,3,2,8,-6,0
Leasing.com Trophy - Northern Group F 2017/18,Bradford City,3,2,0,1,6,6,0,6
Leasing.com Trophy - Northern Group F 2017/18,Chesterfield,3,1,1,1,6,7,-1,5
Leasing.com Trophy - Northern Group F 2017/18,Rotherham United,3,1,1,1,5,3,2,4
Leasing.com Trophy - Northern Group F 2017/18,Manchester City U21,3,0,2,1,4,5,-1,3
Leasing.com Trophy - Northern Group G 2017/18,Lincoln City,3,3,0,0,7,3,4,9
Leasing.com Trophy - Northern Group G 2017/18,Mansfield Town,3,2,0,1,4,4,0,6
Leasing.com Trophy - Northern Group G 2017/18,Notts County,3,1,0,2,4,5,-1,3
Leasing.com Trophy - Northern Group G 2017/18,Everton U21,3,0,0,3,2,5,-3,0
Leasing.com Trophy - Northern Group H 2017/18,Scunthorpe United,3,2,1,0,6,3,3,7
Leasing.com Trophy - Northern Group H 2017/18,Doncaster Rovers,3,1,2,0,3,2,1,7
Leasing.com Trophy - Northern Group H 2017/18,Grimsby Town,3,0,2,1,3,4,-1,2
Leasing.com Trophy - Northern Group H 2017/18,Sunderland U21,3,0,1,2,2,5,-3,2
Leasing.com Trophy - Southern Group A 2017/18,Portsmouth,3,2,1,0,7,4,3,7
Leasing.com Trophy - Southern Group A 2017/18,Charlton Athletic,3,2,0,1,5,3,2,6
Leasing.com Trophy - Southern Group A 2017/18,Fulham U21,3,1,1,1,8,7,1,5
Leasing.com Trophy - Southern Group A 2017/18,Crawley Town,3,0,0,3,2,8,-6,0
Leasing.com Trophy - Southern Group B 2017/18,Gillingham,3,3,0,0,10,6,4,9
Leasing.com Trophy - Southern Group B 2017/18,Southend United,3,2,0,1,4,2,2,6
Leasing.com Trophy - Southern Group B 2017/18,Colchester United,3,0,1,2,2,5,-3,2
Leasing.com Trophy - Southern Group B 2017/18,Reading U21,3,0,1,2,7,10,-3,1
Leasing.com Trophy - Southern Group C 2017/18,Swindon Town,3,2,0,1,7,5,2,6
Leasing.com Trophy - Southern Group C 2017/18,West Ham United U21,3,2,0,1,6,5,1,6
Leasing.com Trophy - Southern Group C 2017/18,Bristol Rovers,3,1,0,2,8,8,0,3
Leasing.com Trophy - Southern Group C 2017/18,Wycombe Wanderers,3,1,0,2,3,6,-3,3
Leasing.com Trophy - Southern Group D 2017/18,Yeovil Town,3,2,1,0,6,3,3,8
Leasing.com Trophy - Southern Group D 2017/18,Chelsea U21,3,1,2,0,6,4,2,5
Leasing.com Trophy - Southern Group D 2017/18,Plymouth Argyle,3,0,2,1,5,6,-1,4
Leasing.com Trophy - Southern Group D 2017/18,Exeter City,3,0,1,2,4,8,-4,1
Leasing.com Trophy - Southern Group E 2017/18,Swansea City U21,3,3,0,0,6,2,4,9
Leasing.com Trophy - Southern Group E 2017/18,Forest Green Rovers,3,2,0,1,4,3,1,6
Leasing.com Trophy - Southern Group E 2017/18,Cheltenham Town,3,1,0,2,4,5,-1,3
Leasing.com Trophy - Southern Group E 2017/18,Newport County AFC,3,0,0,3,2,6,-4,0
Leasing.com Trophy - Southern Group F 2017/18,Luton Town,3,1,2,0,5,4,1,7
Leasing.com Trophy - Southern Group F 2017/18,AFC Wimbledon,3,2,0,1,9,8,1,6
Leasing.com Trophy - Southern Group F 2017/18,Barnet,3,1,1,1,6,6,0,4
Leasing.com Trophy - Southern Group F 2017/18,Tottenham Hotspur U21,3,0,1,2,6,8,-2,1
Leasing.com Trophy - Southern Group G 2017/18,Milton Keynes Dons,3,2,1,0,6,3,3,8
Leasing.com Trophy - Southern Group G 2017/18,Oxford United,3,1,1,1,11,8,3,4
Leasing.com Trophy - Southern Group G 2017/18,Stevenage,3,1,1,1,5,7,-2,4
Leasing.com Trophy - Southern Group G 2017/18,Brighton and Hove Albion U21,3,0,1,2,3,7,-4,2
Leasing.com Trophy - Southern Group H 2017/18,Peterborough United,3,2,1,0,5,1,4,7
Leasing.com Trophy - Southern Group H 2017/18,Northampton Town,3,0,3,0,5,5,0,6
Leasing.com Trophy - Southern Group H 2017/18,Southampton U21,3,1,1,1,4,5,-1,4
Leasing.com Trophy - Southern Group H 2017/18,Cambridge United,3,0,1,2,1,4,-3,1
Leasing.com Trophy - Northern Group A 2018/19,Sunderland,3,2,1,0,4,1,3,8
Leasing.com Trophy - Northern Group A 2018/19,Stoke City U21,3,1,2,0,3,2,1,6
Leasing.com Trophy - Northern Group A 2018/19,Carlisle United,3,1,1,1,5,6,-1,4
Leasing.com Trophy - Northern Group A 2018/19,Morecambe,3,0,0,3,3,6,-3,0
Leasing.com Trophy - Northern Group B 2018/19,Rochdale,3,2,1,0,6,3,3,7
Leasing.com Trophy - Northern Group B 2018/19,Bury,3,2,0,1,6,4,2,6
Leasing.com Trophy - Northern Group B 2018/19,Leicester City U21,3,0,2,1,5,6,-1,4
Leasing.com Trophy - Northern Group B 2018/19,Fleetwood Town,3,0,1,2,3,7,-4,1
Leasing.com Trophy - Northern Group C 2018/19,Accrington Stanley,3,2,0,1,8,5,3,6
Leasing.com Trophy - Northern Group C 2018/19,Macclesfield Town,3,1,1,1,6,8,-2,5
Leasing.com Trophy - Northern Group C 2018/19,Blackpool,3,1,1,1,7,7,0,4
Leasing.com Trophy - Northern Group C 2018/19,West Bromwich Albion U21,3,1,0,2,4,5,-1,3
Leasing.com Trophy - Northern Group D 2018/19,Shrewsbury Town,3,2,1,0,9,2,7,8
Leasing.com Trophy - Northern Group D 2018/19,Manchester City U21,3,2,1,0,6,2,4,7
Leasing.com Trophy - Northern Group D 2018/19,Crewe Alexandra,3,1,0,2,6,9,-3,3
Leasing.com Trophy - Northern Group D 2018/19,Tranmere Rovers,3,0,0,3,3,11,-8,0
Leasing.com Trophy - Northern Group E 2018/19,Port Vale,3,3,0,0,5,1,4,9
Leasing.com Trophy - Northern Group E 2018/19,Walsall,3,2,0,1,6,4,2,6
Leasing.com Trophy - Northern Group E 2018/19,Middlesbrough U21,3,1,0,2,2,5,-3,3
Leasing.com Trophy - Northern Group E 2018/19,Burton Albion,3,0,0,3,1,4,-3,0
Leasing.com Trophy - Northern Group F 2018/19,Barnsley,3,2,1,0,5,3,2,8
Leasing.com Trophy - Northern Group F 2018/19,Oldham Athletic,3,2,0,1,8,5,3,6
Leasing.com Trophy - Northern Group F 2018/19,Everton U21,3,0,2,1,4,5,-1,2
Leasing.com Trophy - Northern Group F 2018/19,Bradford City,3,0,1,2,3,7,-4,2
Leasing.com Trophy - Northern Group G 2018/19,Newcastle United U21,3,3,0,0,8,3,5,9
Leasing.com Trophy - Northern Group G 2018/19,Notts County,3,1,0,2,5,6,-1,3
Leasing.com Trophy - Northern Group G 2018/19,Doncaster Rovers,3,1,0,2,5,7,-2,3
Leasing.com Trophy - Northern Group G 2018/19,Grimsby Town,3,1,0,2,4,6,-2,3
Leasing.com Trophy - Northern Group H 2018/19,Mansfield Town,3,3,0,0,7,4,3,9
Leasing.com Trophy - Northern Group H 2018/19,Lincoln City,3,0,2,1,4,5,-1,3
Leasing.com Trophy - Northern Group H 2018/19,Scunthorpe United,3,0,2,1,3,4,-1,3
Leasing.com Trophy - Northern Group H 2018/19,Wolverhampton Wanderers U21,3,0,2,1,3,4,-1,3
Leasing.com Trophy - Southern Group A 2018/19,Portsmouth,3,3,0,0,8,2,6,9
Leasing.com Trophy - Southern Group A 2018/19,Tottenham Hotspur U21,3,1,1,1,7,4,3,4
Leasing.com Trophy - Southern Group A 2018/19,Gillingham,3,1,0,2,2,9,-7,3
Leasing.com Trophy - Southern Group A 2018/19,Crawley Town,3,0,1,2,2,4,-2,2
Leasing.com Trophy - Southern Group B 2018/19,Cambridge United,3,2,0,1,8,4,4,6
Leasing.com Trophy - Southern Group B 2018/19,Southend United,3,2,0,1,6,3,3,6
Leasing.com Trophy - Southern Group B 2018/19,Colchester United,3,1,0,2,3,5,-2,3
Leasing.com Trophy - Southern Group B 2018/19,Southampton U21,3,1,0,2,2,7,-5,3
Leasing.com Trophy - Southern Group C 2018/19,Chelsea U21,3,2,0,1,9,3,6,6
Leasing.com Trophy - Southern Group C 2018/19,Newport County AFC,3,2,0,1,5,1,4,6
Leasing.com Trophy - Southern Group C 2018/19,Swindon Town,3,2,0,1,4,4,0,6
Leasing.com Trophy - Southern Group C 2018/19,Plymouth Argyle,3,0,0,3,0,10,-10,0
Leasing.com Trophy - Southern Group D 2018/19,Exeter City,3,2,1,0,4,0,4,8
Leasing.com Trophy - Southern Group D 2018/19,Bristol Rovers,3,2,0,1,4,2,2,6
Leasing.com Trophy - Southern Group D 2018/19,Yeovil Town,3,1,1,1,4,2,2,4
Leasing.com Trophy - Southern Group D 2018/19,West Ham United U21,3,0,0,3,0,8,-8,0
Leasing.com Trophy - Southern Group E 2018/19,Cheltenham Town,3,2,0,1,8,6,2,6
Leasing.com Trophy - Southern Group E 2018/19,Arsenal U21,3,2,0,1,8,7,1,6
Leasing.com Trophy - Southern Group E 2018/19,Forest Green Rovers,3,1,1,1,6,4,2,4
Leasing.com Trophy - Southern Group E 2018/19,Coventry City,3,0,1,2,1,6,-5,2
Leasing.com Trophy - Southern Group F 2018/19,Oxford United,3,2,0,1,7,2,5,6
Leasing.com Trophy - Southern Group F 2018/19,Northampton Town,3,2,0,1,4,2,2,6
Leasing.com Trophy - Southern Group F 2018/19,Wycombe Wanderers,3,2,0,1,3,4,-1,6
Leasing.com Trophy - Southern Group F 2018/19,Fulham U21,3,0,0,3,1,7,-6,0
Leasing.com Trophy - Southern Group G 2018/19,Swansea City U21,3,2,0,1,2,5,-3,6
Leasing.com Trophy - Southern Group G 2018/19,AFC Wimbledon,3,1,1,1,6,3,3,5
Leasing.com Trophy - Southern Group G 2018/19,Charlton Athletic,3,1,1,1,10,3,7,4
Leasing.com Trophy - Southern Group G 2018/19,Stevenage,3,1,0,2,5,12,-7,3
Leasing.com Trophy - Southern Group H 2018/19,Luton Town,3,2,0,1,6,3,3,6
Leasing.com Trophy - Southern Group H 2018/19,Peterborough United,3,1,2,0,7,6,1,5
Leasing.com Trophy - Southern Group H 2018/19,Brighton and Hove Albion U21,3,1,1,1,6,6,0,5
Leasing.com Trophy - Southern Group H 2018/19,Milton Keynes Dons,3,0,1,2,5,9,-4,2
Leasing.com Trophy - Northern Group A 2019/20,Leicester City U21,3,2,1,0,5,3,2,8
Leasing.com Trophy - Northern Group A 2019/20,Scunthorpe United,3,2,1,0,6,2,4,7
Leasing.com Trophy - Northern Group A 2019/20,Sunderland,3,1,0,2,4,7,-3,3
Leasing.com Trophy - Northern Group A 2019/20,Grimsby Town,3,0,0,3,4,7,-3,0
Leasing.com Trophy - Northern Group B 2019/20,Accrington Stanley,3,3,0,0,10,3,7,9
Leasing.com Trophy - Northern Group B 2019/20,Fleetwood Town,3,1,1,1,7,5,2,5
Leasing.com Trophy - Northern Group B 2019/20,Oldham Athletic,3,1,0,2,5,10,-5,3
Leasing.com Trophy - Northern Group B 2019/20,Liverpool U21,3,0,1,2,5,9,-4,1
Leasing.com Trophy - Northern Group D 2019/20,Port Vale,3,3,0,0,7,4,3,9
Leasing.com Trophy - Northern Group D 2019/20,Shrewsbury Town,3,2,0,1,7,3,4,6
Leasing.com Trophy - Northern Group D 2019/20,Macclesfield Town,3,1,0,2,5,7,-2,3
Leasing.com Trophy - Northern Group D 2019/20,Newcastle United U21,3,0,0,3,2,7,-5,0
Leasing.com Trophy - Northern Group E 2019/20,Everton U21,3,1,2,0,5,3,2,6
Leasing.com Trophy - Northern Group E 2019/20,Mansfield Town,3,1,2,0,4,3,1,5
Leasing.com Trophy - Northern Group E 2019/20,Crewe Alexandra,3,0,2,1,4,6,-2,4
Leasing.com Trophy - Northern Group E 2019/20,Burton Albion,3,1,0,2,4,5,-1,3
Leasing.com Trophy - Northern Group F 2019/20,Manchester City U21,3,2,0,1,5,4,1,6
Leasing.com Trophy - Northern Group F 2019/20,Bolton Wanderers,3,1,2,0,5,3,2,5
Leasing.com Trophy - Northern Group F 2019/20,Rochdale,3,1,1,1,3,4,-1,5
Leasing.com Trophy - Northern Group F 2019/20,Bradford City,3,0,1,2,3,5,-2,2
Leasing.com Trophy - Northern Group G 2019/20,Blackpool,3,2,0,1,7,3,4,6
Leasing.com Trophy - Northern Group G 2019/20,Wolverhampton Wanderers U21,3,1,1,1,6,5,1,5
Leasing.com Trophy - Northern Group G 2019/20,Morecambe,3,1,1,1,6,8,-2,4
Leasing.com Trophy - Northern Group G 2019/20,Carlisle United,3,1,0,2,5,8,-3,3
Leasing.com Trophy - Northern Group H 2019/20,Manchester United U21,3,3,0,0,5,1,4,9
Leasing.com Trophy - Northern Group H 2019/20,Doncaster Rovers,3,1,0,2,6,6,0,3
Leasing.com Trophy - Northern Group H 2019/20,Lincoln City,3,1,0,2,4,4,0,3
Leasing.com Trophy - Northern Group H 2019/20,Rotherham United,3,1,0,2,3,7,-4,3
Leasing.com Trophy - Southern Group A 2019/20,Colchester United,3,2,1,0,5,3,2,7
Leasing.com Trophy - Southern Group A 2019/20,Ipswich Town,3,2,0,1,6,2,4,6
Leasing.com Trophy - Southern Group A 2019/20,Gillingham,3,1,0,2,4,7,-3,3
Leasing.com Trophy - Southern Group A 2019/20,Tottenham Hotspur U21,3,0,1,2,2,5,-3,2
Leasing.com Trophy - Southern Group B 2019/20,Portsmouth,3,2,1,0,6,3,3,8
Leasing.com Trophy - Southern Group B 2019/20,Oxford United,3,2,1,0,8,4,4,7
Leasing.com Trophy - Southern Group B 2019/20,Norwich City U21,3,1,0,2,4,6,-2,3
Leasing.com Trophy - Southern Group B 2019/20,Crawley Town,3,0,0,3,2,7,-5,0
Leasing.com Trophy - Southern Group C 2019/20,Brighton and Hove Albion U21,3,2,1,0,5,1,4,7
Leasing.com Trophy - Southern Group C 2019/20,Leyton Orient,3,1,1,1,3,4,-1,5
Leasing.com Trophy - Southern Group C 2019/20,AFC Wimbledon,3,1,0,2,4,5,-1,3
Leasing.com Trophy - Southern Group C 2019/20,Southend United,3,1,0,2,3,5,-2,3
Leasing.com Trophy - Southern Group D 2019/20,Walsall,3,2,1,0,7,0,7,7
Leasing.com Trophy - Southern Group D 2019/20,Coventry City,3,1,2,0,3,2,1,6
Leasing.com Trophy - Southern Group D 2019/20,Forest Green Rovers,3,1,1,1,3,8,-5,5
Leasing.com Trophy - Southern Group D 2019/20,Southampton U21,3,0,0,3,4,7,-3,0
Leasing.com Trophy - Southern Group E 2019/20,Exeter City,3,3,0,0,6,1,5,9
Leasing.com Trophy - Southern Group E 2019/20,Newport County AFC,3,1,0,2,11,11,0,3
Leasing.com Trophy - Southern Group E 2019/20,West Ham United U21,3,1,0,2,9,11,-2,3
Leasing.com Trophy - Southern Group E 2019/20,Cheltenham Town,3,1,0,2,8,11,-3,3
Leasing.com Trophy - Southern Group F 2019/20,Bristol Rovers,3,2,1,0,4,2,2,7
Leasing.com Trophy - Southern Group F 2019/20,Chelsea U21,3,2,0,1,5,4,1,6
Leasing.com Trophy - Southern Group F 2019/20,Plymouth Argyle,3,1,1,1,4,2,2,5
Leasing.com Trophy - Southern Group F 2019/20,Swindon Town,3,0,0,3,2,7,-5,0
Leasing.com Trophy - Southern Group G 2019/20,Milton Keynes Dons,3,2,0,1,5,2,3,6
Leasing.com Trophy - Southern Group G 2019/20,Stevenage,3,1,1,1,2,4,-2,5
Leasing.com Trophy - Southern Group G 2019/20,Fulham U21,3,1,1,1,3,3,0,4
Leasing.com Trophy - Southern Group G 2019/20,Wycombe Wanderers,3,1,0,2,3,4,-1,3
Leasing.com Trophy - Southern Group H 2019/20,Peterborough United,3,3,0,0,5,1,4,9
Leasing.com Trophy - Southern Group H 2019/20,Northampton Town,3,1,1,1,2,3,-1,5
Leasing.com Trophy - Southern Group H 2019/20,Arsenal U21,3,0,2,1,2,3,-1,3
Leasing.com Trophy - Southern Group H 2019/20,Cambridge United,3,0,1,2,2,4,-2,1
Papa John's Trophy - Northern Group A 2020/21,Sunderland,2,2,0,0,13,4,9,6
Papa John's Trophy - Northern Group A 2020/21,Fleetwood Town,2,2,0,0,6,1,5,6
Papa John's Trophy - Northern Group A 2020/21,Carlisle United,2,0,0,2,4,8,-4,0
Papa John's Trophy - Northern Group A 2020/21,Aston Villa U21,2,0,0,2,1,11,-10,0
Papa John's Trophy - Northern Group B 2020/21,Manchester United U21,2,1,1,0,6,0,6,5
Papa John's Trophy - Northern Group B 2020/21,Rochdale,2,1,1,0,2,1,1,4
Papa John's Trophy - Northern Group B 2020/21,Salford City,2,1,0,1,2,6,-4,3
Papa John's Trophy - Northern Group B 2020/21,Morecambe,2,0,0,2,1,4,-3,0
Papa John's Trophy - Northern Group C 2020/21,Shrewsbury Town,2,2,0,0,5,1,4,6
Papa John's Trophy - Northern Group C 2020/21,Crewe Alexandra,2,2,0,0,4,2,2,6
Papa John's Trophy - Northern Group C 2020/21,Bolton Wanderers,2,0,0,2,3,5,-2,0
Papa John's Trophy - Northern Group C 2020/21,Newcastle United U21,2,0,0,2,0,4,-4,0
Papa John's Trophy - Northern Group D 2020/21,Port Vale,2,1,1,0,3,1,2,5
Papa John's Trophy - Northern Group D 2020/21,Tranmere Rovers,2,1,1,0,3,2,1,4
Papa John's Trophy - Northern Group D 2020/21,Wigan Athletic,2,1,0,1,7,4,3,3
Papa John's Trophy - Northern Group D 2020/21,Liverpool U21,2,0,0,2,3,9,-6,0
Papa John's Trophy - Northern Group E 2020/21,Manchester City U21,2,2,0,0,7,0,7,6
Papa John's Trophy - Northern Group E 2020/21,Lincoln City,2,1,1,0,4,2,2,5
Papa John's Trophy - Northern Group E 2020/21,Scunthorpe United,2,0,1,1,1,5,-4,1
Papa John's Trophy - Northern Group E 2020/21,Mansfield Town,2,0,0,2,1,6,-5,0
Papa John's Trophy - Northern Group F 2020/21,Oldham Athletic,2,2,0,0,6,0,6,6
Papa John's Trophy - Northern Group F 2020/21,Bradford City,2,0,2,0,1,1,0,2
Papa John's Trophy - Northern Group F 2020/21,Doncaster Rovers,2,0,1,1,0,2,-2,2
Papa John's Trophy - Northern Group F 2020/21,Wolverhampton Wanderers U21,2,0,1,1,1,5,-4,2
Papa John's Trophy - Northern Group G 2020/21,Accrington Stanley,2,1,1,0,8,1,7,5
Papa John's Trophy - Northern Group G 2020/21,Barrow,2,0,2,0,2,2,0,3
Papa John's Trophy - Northern Group G 2020/21,Blackpool,2,0,2,0,1,1,0,3
Papa John's Trophy - Northern Group G 2020/21,Leeds United U21,2,0,1,1,2,9,-7,1
Papa John's Trophy - Northern Group H 2020/21,Harrogate Town,2,1,1,0,5,3,2,4
Papa John's Trophy - Northern Group H 2020/21,Leicester City U21,2,1,0,1,3,4,-1,3
Papa John's Trophy - Northern Group H 2020/21,Grimsby Town,1,0,1,0,2,2,0,2
Papa John's Trophy - Northern Group H 2020/21,Hull City,1,0,0,1,1,2,-1,0
Papa John's Trophy - Southern Group A 2020/21,Portsmouth,2,2,0,0,5,0,5,6
Papa John's Trophy - Southern Group A 2020/21,West Ham United U21,2,2,0,0,4,1,3,6
Papa John's Trophy - Southern Group A 2020/21,Colchester United,2,0,0,2,0,3,-3,0
Papa John's Trophy - Southern Group A 2020/21,Southend United,2,0,0,2,1,6,-5,0
Papa John's Trophy - Southern Group B 2020/21,Arsenal U21,2,2,0,0,4,2,2,6
Papa John's Trophy - Southern Group B 2020/21,Ipswich Town,2,1,0,1,3,2,1,3
Papa John's Trophy - Southern Group B 2020/21,Gillingham,2,1,0,1,2,3,-1,3
Papa John's Trophy - Southern Group B 2020/21,Crawley Town,2,0,0,2,2,4,-2,0
Papa John's Trophy - Southern Group C 2020/21,Milton Keynes Dons,2,2,0,0,6,3,3,6
Papa John's Trophy - Southern Group C 2020/21,Northampton Town,2,1,0,1,6,3,3,3
Papa John's Trophy - Southern Group C 2020/21,Stevenage,2,1,0,1,4,4,0,3
Papa John's Trophy - Southern Group C 2020/21,Southampton U21,2,0,0,2,1,7,-6,0
Papa John's Trophy - Southern Group D 2020/21,Oxford United,2,1,1,0,3,2,1,5
Papa John's Trophy - Southern Group D 2020/21,Walsall,2,0,2,0,3,3,0,3
Papa John's Trophy - Southern Group D 2020/21,Bristol Rovers,2,0,2,0,3,3,0,2
Papa John's Trophy - Southern Group D 2020/21,Chelsea U21,2,0,1,1,2,3,-1,2
Papa John's Trophy - Southern Group E 2020/21,Exeter City,2,2,0,0,7,5,2,6
Papa John's Trophy - Southern Group E 2020/21,Forest Green Rovers,2,1,0,1,5,3,2,3
Papa John's Trophy - Southern Group E 2020/21,West Bromwich Albion U21,2,1,0,1,3,5,-2,3
Papa John's Trophy - Southern Group E 2020/21,Swindon Town,2,0,0,2,5,7,-2,0
Papa John's Trophy - Southern Group F 2020/21,Norwich City U21,2,2,0,0,8,2,6,6
Papa John's Trophy - Southern Group F 2020/21,Cheltenham Town,2,2,0,0,3,0,3,6
Papa John's Trophy - Southern Group F 2020/21,Plymouth Argyle,2,0,0,2,2,5,-3,0
Papa John's Trophy - Southern Group F 2020/21,Newport County AFC,2,0,0,2,0,6,-6,0
Papa John's Trophy - Southern Group G 2020/21,Leyton Orient,2,2,0,0,5,2,3,6
Papa John's Trophy - Southern Group G 2020/21,AFC Wimbledon,3,2,0,1,4,3,1,6
Papa John's Trophy - Southern Group G 2020/21,Charlton Athletic,2,0,1,1,2,3,-1,2
Papa John's Trophy - Southern Group G 2020/21,Brighton and Hove Albion U21,3,0,1,2,3,6,-3,1
Papa John's Trophy - Southern Group H 2020/21,Cambridge United,2,2,0,0,6,2,4,6
Papa John's Trophy - Southern Group H 2020/21,Peterborough United,2,1,1,0,7,5,2,5
Papa John's Trophy - Southern Group H 2020/21,Burton Albion,2,0,1,1,5,7,-2,1
Papa John's Trophy - Southern Group H 2020/21,Fulham U21,2,0,0,2,2,6,-4,0
Dutch Eredivisie 2009/10,FC Twente,34,27,5,2,63,23,40,86
Dutch Eredivisie 2009/10,Ajax,34,27,4,3,106,20,86,85
Dutch Eredivisie 2009/10,PSV Eindhoven,34,23,9,2,72,29,43,78
Dutch Eredivisie 2009/10,Feyenoord,34,17,12,5,54,31,23,63
Dutch Eredivisie 2009/10,AZ Alkmaar,34,19,5,10,64,34,30,62
Dutch Eredivisie 2009/10,Heracles Almelo,34,17,5,12,54,49,5,56
Dutch Eredivisie 2009/10,FC Utrecht,34,14,11,9,39,33,6,53
Dutch Eredivisie 2009/10,Groningen,34,14,7,13,48,47,1,49
Dutch Eredivisie 2009/10,Roda JC Kerk,34,14,5,15,56,60,-4,47
Dutch Eredivisie 2009/10,NAC Breda,34,12,10,12,42,49,-7,46
Dutch Eredivisie 2009/10,Heerenveen,34,11,4,19,44,64,-20,37
Dutch Eredivisie 2009/10,VVV,34,8,11,15,43,57,-14,35
Dutch Eredivisie 2009/10,NEC Nijmegen,34,8,9,17,35,59,-24,33
Dutch Eredivisie 2009/10,Vitesse Arnhem,34,8,8,18,38,62,-24,32
Dutch Eredivisie 2009/10,ADO Den Haag,34,7,9,18,38,59,-21,30
Dutch Eredivisie 2009/10,Sparta Rotterdam,34,6,8,20,30,66,-36,26
Dutch Eredivisie 2009/10,Willem II,34,7,2,25,36,70,-34,23
Dutch Eredivisie 2009/10,RKC Waalwijk,34,5,0,29,30,80,-50,15
Dutch Eredivisie 2010/11,Ajax,34,22,7,5,72,30,42,73
Dutch Eredivisie 2010/11,FC Twente,34,21,8,5,65,34,31,71
Dutch Eredivisie 2010/11,PSV Eindhoven,34,20,9,5,79,34,45,69
Dutch Eredivisie 2010/11,AZ Alkmaar,34,17,8,9,55,44,11,59
Dutch Eredivisie 2010/11,Groningen,34,17,6,11,65,52,13,57
Dutch Eredivisie 2010/11,Roda JC Kerk,34,14,13,7,65,50,15,55
Dutch Eredivisie 2010/11,ADO Den Haag,34,16,6,12,63,55,8,54
Dutch Eredivisie 2010/11,Heracles Almelo,34,14,7,13,65,56,9,49
Dutch Eredivisie 2010/11,FC Utrecht,34,13,8,13,55,51,4,47
Dutch Eredivisie 2010/11,Feyenoord,34,12,8,14,53,54,-1,44
Dutch Eredivisie 2010/11,NEC Nijmegen,34,10,13,11,57,56,1,43
Dutch Eredivisie 2010/11,Heerenveen,34,10,11,13,60,54,6,41
Dutch Eredivisie 2010/11,NAC Breda *,34,12,5,17,44,60,-16,40
Dutch Eredivisie 2010/11,De Graafschap,34,9,11,14,31,56,-25,38
Dutch Eredivisie 2010/11,Vitesse Arnhem,34,9,8,17,42,61,-19,35
Dutch Eredivisie 2010/11,Excelsior,34,10,5,19,45,66,-21,35
Dutch Eredivisie 2010/11,VVV,34,6,3,25,34,76,-42,21
Dutch Eredivisie 2010/11,Willem II,34,3,6,25,37,98,-61,15
Dutch Eredivisie 2011/12,Ajax,34,23,7,4,93,36,57,76
Dutch Eredivisie 2011/12,Feyenoord,34,21,7,6,70,37,33,70
Dutch Eredivisie 2011/12,PSV Eindhoven,34,21,6,7,87,47,40,69
Dutch Eredivisie 2011/12,AZ Alkmaar,34,19,8,7,64,35,29,65
Dutch Eredivisie 2011/12,Heerenveen,34,18,10,6,79,59,20,64
Dutch Eredivisie 2011/12,FC Twente,34,17,9,8,82,46,36,60
Dutch Eredivisie 2011/12,Vitesse Arnhem,34,15,8,11,48,43,5,53
Dutch Eredivisie 2011/12,RKC Waalwijk,34,13,7,14,41,49,-8,46
Dutch Eredivisie 2011/12,NEC Nijmegen,34,13,6,15,42,45,-3,45
Dutch Eredivisie 2011/12,Roda JC Kerk,34,14,2,18,55,70,-15,44
Dutch Eredivisie 2011/12,FC Utrecht,34,11,10,13,55,58,-3,43
Dutch Eredivisie 2011/12,Heracles Almelo,34,11,7,16,52,62,-10,40
Dutch Eredivisie 2011/12,Groningen,34,10,7,17,41,61,-20,37
Dutch Eredivisie 2011/12,NAC Breda,34,9,9,16,45,55,-10,36
Dutch Eredivisie 2011/12,ADO Den Haag,34,8,8,18,38,67,-29,32
Dutch Eredivisie 2011/12,VVV,34,9,4,21,42,78,-36,31
Dutch Eredivisie 2011/12,De Graafschap,34,6,6,22,36,74,-38,24
Dutch Eredivisie 2011/12,Excelsior,34,4,7,23,28,76,-48,19
Dutch Eredivisie 2012/13,Ajax,34,22,10,2,83,31,52,76
Dutch Eredivisie 2012/13,PSV Eindhoven,34,22,3,9,103,43,60,69
Dutch Eredivisie 2012/13,Feyenoord,34,21,6,7,64,38,26,69
Dutch Eredivisie 2012/13,Vitesse Arnhem,34,19,7,8,68,42,26,64
Dutch Eredivisie 2012/13,FC Utrecht,34,19,6,9,55,41,14,63
Dutch Eredivisie 2012/13,FC Twente,34,17,11,6,60,33,27,62
Dutch Eredivisie 2012/13,Groningen,34,12,7,15,36,53,-17,43
Dutch Eredivisie 2012/13,Heerenveen,34,11,9,14,50,63,-13,42
Dutch Eredivisie 2012/13,ADO Den Haag,34,9,13,12,49,63,-14,40
Dutch Eredivisie 2012/13,AZ Alkmaar,34,10,9,15,56,54,2,39
Dutch Eredivisie 2012/13,PEC Zwolle,34,10,9,15,42,55,-13,39
Dutch Eredivisie 2012/13,Heracles Almelo,34,9,11,14,58,71,-13,38
Dutch Eredivisie 2012/13,NAC Breda,34,10,8,16,40,56,-16,38
Dutch Eredivisie 2012/13,RKC Waalwijk,34,9,10,15,39,48,-9,37
Dutch Eredivisie 2012/13,NEC Nijmegen,34,10,7,17,44,66,-22,37
Dutch Eredivisie 2012/13,Roda JC Kerk,34,7,12,15,51,69,-18,33
Dutch Eredivisie 2012/13,VVV,34,6,10,18,33,62,-29,28
Dutch Eredivisie 2012/13,Willem II,34,5,8,21,33,76,-43,23
Dutch Eredivisie 2013/14,Ajax,34,20,11,3,69,28,41,71
Dutch Eredivisie 2013/14,Feyenoord,34,20,7,7,76,40,36,67
Dutch Eredivisie 2013/14,FC Twente,34,17,12,5,72,37,35,63
Dutch Eredivisie 2013/14,PSV Eindhoven,34,18,5,11,60,45,15,59
Dutch Eredivisie 2013/14,Heerenveen,34,16,9,9,72,51,21,57
Dutch Eredivisie 2013/14,Vitesse Arnhem,34,15,10,9,65,51,14,55
Dutch Eredivisie 2013/14,Groningen,34,14,9,11,57,55,2,51
Dutch Eredivisie 2013/14,AZ Alkmaar,34,13,8,13,54,50,4,47
Dutch Eredivisie 2013/14,ADO Den Haag,34,12,7,15,45,64,-19,43
Dutch Eredivisie 2013/14,FC Utrecht,34,11,8,15,46,65,-19,41
Dutch Eredivisie 2013/14,PEC Zwolle,34,9,13,12,47,49,-2,40
Dutch Eredivisie 2013/14,Cambuur Leeuwarden,34,10,9,15,40,50,-10,39
Dutch Eredivisie 2013/14,Go Ahead Eagles,34,10,8,16,45,69,-24,38
Dutch Eredivisie 2013/14,Heracles Almelo,34,10,7,17,45,59,-14,37
Dutch Eredivisie 2013/14,NAC Breda,34,8,11,15,43,54,-11,35
Dutch Eredivisie 2013/14,RKC Waalwijk,34,7,11,16,44,64,-20,32
Dutch Eredivisie 2013/14,NEC Nijmegen,34,5,15,14,54,82,-28,30
Dutch Eredivisie 2013/14,Roda JC Kerk,34,7,8,19,44,69,-25,29
Dutch Eredivisie 2014/15,PSV Eindhoven,34,29,1,4,92,31,61,88
Dutch Eredivisie 2014/15,Ajax,34,21,8,5,69,29,40,71
Dutch Eredivisie 2014/15,AZ Alkmaar,34,19,5,10,63,56,7,62
Dutch Eredivisie 2014/15,Feyenoord,34,17,8,9,56,39,17,59
Dutch Eredivisie 2014/15,Vitesse Arnhem,34,16,10,8,66,43,23,58
Dutch Eredivisie 2014/15,PEC Zwolle,34,16,5,13,59,43,16,53
Dutch Eredivisie 2014/15,Heerenveen,34,13,11,10,53,46,7,50
Dutch Eredivisie 2014/15,Groningen,34,11,13,10,49,53,-4,46
Dutch Eredivisie 2014/15,Willem II,34,13,7,14,46,50,-4,46
Dutch Eredivisie 2014/15,FC Twente *,34,13,10,11,56,51,5,43
Dutch Eredivisie 2014/15,FC Utrecht,34,11,8,15,60,62,-2,41
Dutch Eredivisie 2014/15,Cambuur Leeuwarden,34,11,8,15,46,56,-10,41
Dutch Eredivisie 2014/15,ADO Den Haag,34,9,10,15,44,53,-9,37
Dutch Eredivisie 2014/15,Heracles Almelo,34,11,4,19,47,64,-17,37
Dutch Eredivisie 2014/15,Excelsior,34,6,14,14,47,63,-16,32
Dutch Eredivisie 2014/15,NAC Breda,34,6,10,18,36,68,-32,28
Dutch Eredivisie 2014/15,Go Ahead Eagles,34,7,6,21,29,59,-30,27
Dutch Eredivisie 2014/15,FC Dordrecht,34,4,8,22,24,76,-52,20
Dutch Eredivisie 2015/16,PSV Eindhoven,34,26,6,2,88,32,56,84
Dutch Eredivisie 2015/16,Ajax,34,25,7,2,81,21,60,82
Dutch Eredivisie 2015/16,Feyenoord,34,19,6,9,62,40,22,63
Dutch Eredivisie 2015/16,AZ Alkmaar,34,18,5,11,70,53,17,59
Dutch Eredivisie 2015/16,FC Utrecht,34,15,8,11,57,48,9,53
Dutch Eredivisie 2015/16,Heracles Almelo,34,14,9,11,47,49,-2,51
Dutch Eredivisie 2015/16,Groningen,34,14,8,12,41,48,-7,50
Dutch Eredivisie 2015/16,PEC Zwolle,34,14,6,14,56,54,2,48
Dutch Eredivisie 2015/16,Vitesse Arnhem,34,12,10,12,55,38,17,46
Dutch Eredivisie 2015/16,NEC Nijmegen,34,13,7,14,37,42,-5,46
Dutch Eredivisie 2015/16,ADO Den Haag,34,10,13,11,48,49,-1,43
Dutch Eredivisie 2015/16,Heerenveen,34,11,9,14,46,61,-15,42
Dutch Eredivisie 2015/16,FC Twente *,34,12,7,15,49,64,-15,40
Dutch Eredivisie 2015/16,Roda JC Kerk,34,8,10,16,34,55,-21,34
Dutch Eredivisie 2015/16,Excelsior,34,7,9,18,34,60,-26,30
Dutch Eredivisie 2015/16,Willem II,34,6,11,17,35,53,-18,29
Dutch Eredivisie 2015/16,De Graafschap,34,5,8,21,39,66,-27,23
Dutch Eredivisie 2015/16,Cambuur Leeuwarden,34,3,9,22,33,79,-46,18
Dutch Eredivisie 2016/17,Feyenoord,34,26,4,4,86,25,61,82
Dutch Eredivisie 2016/17,Ajax,34,25,6,3,79,23,56,81
Dutch Eredivisie 2016/17,PSV Eindhoven,34,22,10,2,68,23,45,76
Dutch Eredivisie 2016/17,FC Utrecht,34,18,8,8,54,38,16,62
Dutch Eredivisie 2016/17,Vitesse Arnhem,34,15,6,13,51,40,11,51
Dutch Eredivisie 2016/17,AZ Alkmaar,34,12,13,9,56,52,4,49
Dutch Eredivisie 2016/17,FC Twente,34,12,9,13,48,50,-2,45
Dutch Eredivisie 2016/17,Groningen,34,10,13,11,55,51,4,43
Dutch Eredivisie 2016/17,Heerenveen,34,12,7,15,54,53,1,43
Dutch Eredivisie 2016/17,Heracles Almelo,34,12,7,15,53,55,-2,43
Dutch Eredivisie 2016/17,ADO Den Haag,34,11,5,18,37,59,-22,38
Dutch Eredivisie 2016/17,Excelsior,34,9,10,15,43,60,-17,37
Dutch Eredivisie 2016/17,Willem II,34,9,9,16,29,44,-15,36
Dutch Eredivisie 2016/17,PEC Zwolle,34,9,8,17,39,67,-28,35
Dutch Eredivisie 2016/17,Sparta Rotterdam,34,9,7,18,42,61,-19,34
Dutch Eredivisie 2016/17,NEC Nijmegen,34,9,7,18,32,59,-27,34
Dutch Eredivisie 2016/17,Roda JC Kerk,34,7,12,15,26,51,-25,33
Dutch Eredivisie 2016/17,Go Ahead Eagles,34,6,5,23,32,73,-41,23
Dutch Eredivisie 2017/18,PSV Eindhoven,34,26,5,3,87,39,48,83
Dutch Eredivisie 2017/18,Ajax,34,25,4,5,89,33,56,79
Dutch Eredivisie 2017/18,AZ Alkmaar,34,22,5,7,72,38,34,71
Dutch Eredivisie 2017/18,Feyenoord,34,20,6,8,76,39,37,66
Dutch Eredivisie 2017/18,FC Utrecht,34,14,12,8,58,53,5,54
Dutch Eredivisie 2017/18,Vitesse Arnhem,34,13,10,11,63,47,16,49
Dutch Eredivisie 2017/18,ADO Den Haag,34,13,8,13,45,53,-8,47
Dutch Eredivisie 2017/18,Heerenveen,34,12,10,12,48,53,-5,46
Dutch Eredivisie 2017/18,PEC Zwolle,34,12,8,14,42,54,-12,44
Dutch Eredivisie 2017/18,Heracles Almelo,34,11,9,14,50,64,-14,42
Dutch Eredivisie 2017/18,Excelsior,34,11,7,16,41,56,-15,40
Dutch Eredivisie 2017/18,Groningen,34,8,14,12,50,50,0,38
Dutch Eredivisie 2017/18,Willem II,34,10,7,17,50,63,-13,37
Dutch Eredivisie 2017/18,NAC Breda,34,9,7,18,41,57,-16,34
Dutch Eredivisie 2017/18,VVV-Venlo,34,7,13,14,35,54,-19,34
Dutch Eredivisie 2017/18,Roda JC Kerk,34,8,6,20,42,69,-27,30
Dutch Eredivisie 2017/18,Sparta Rotterdam,34,7,6,21,34,75,-41,27
Dutch Eredivisie 2017/18,FC Twente,34,5,9,20,37,63,-26,24
Dutch Eredivisie 2018/19,Ajax,34,28,2,4,119,32,87,86
Dutch Eredivisie 2018/19,PSV Eindhoven,34,26,5,3,98,26,72,83
Dutch Eredivisie 2018/19,Feyenoord,34,20,5,9,75,41,34,65
Dutch Eredivisie 2018/19,AZ Alkmaar,34,17,7,10,64,43,21,58
Dutch Eredivisie 2018/19,Vitesse Arnhem,34,14,11,9,70,51,19,53
Dutch Eredivisie 2018/19,FC Utrecht,34,15,8,11,60,51,9,53
Dutch Eredivisie 2018/19,Heracles Almelo,34,15,3,16,61,68,-7,48
Dutch Eredivisie 2018/19,Groningen,34,13,6,15,39,41,-2,45
Dutch Eredivisie 2018/19,ADO Den Haag,34,12,9,13,58,63,-5,45
Dutch Eredivisie 2018/19,Willem II,34,13,5,16,58,72,-14,44
Dutch Eredivisie 2018/19,Heerenveen,34,10,11,13,64,73,-9,41
Dutch Eredivisie 2018/19,VVV-Venlo,34,11,8,15,47,63,-16,41
Dutch Eredivisie 2018/19,PEC Zwolle,34,11,6,17,44,57,-13,39
Dutch Eredivisie 2018/19,Emmen,34,10,8,16,41,72,-31,38
Dutch Eredivisie 2018/19,Fortuna Sittard,34,9,7,18,50,80,-30,34
Dutch Eredivisie 2018/19,Excelsior,34,9,6,19,46,79,-33,33
Dutch Eredivisie 2018/19,De Graafschap,34,8,5,21,38,75,-37,29
Dutch Eredivisie 2018/19,NAC Breda,34,5,8,21,29,74,-45,23
Dutch Eredivisie 2019/20,Ajax,25,18,2,5,68,23,45,56
Dutch Eredivisie 2019/20,AZ Alkmaar,25,18,2,5,54,17,37,56
Dutch Eredivisie 2019/20,Feyenoord,25,14,8,3,50,35,15,50
Dutch Eredivisie 2019/20,PSV Eindhoven,26,14,7,5,54,28,26,49
Dutch Eredivisie 2019/20,Willem II,26,13,5,8,37,34,3,44
Dutch Eredivisie 2019/20,FC Utrecht,25,12,5,8,50,34,16,41
Dutch Eredivisie 2019/20,Vitesse Arnhem,26,12,5,9,45,35,10,41
Dutch Eredivisie 2019/20,Heracles Almelo,26,10,6,10,40,34,6,36
Dutch Eredivisie 2019/20,Groningen,26,10,5,11,27,26,1,35
Dutch Eredivisie 2019/20,Heerenveen,26,8,9,9,41,41,0,33
Dutch Eredivisie 2019/20,Sparta Rotterdam,26,9,6,11,41,45,-4,33
Dutch Eredivisie 2019/20,Emmen,26,9,5,12,32,45,-13,32
Dutch Eredivisie 2019/20,VVV-Venlo,26,8,4,14,24,51,-27,28
Dutch Eredivisie 2019/20,FC Twente,26,7,6,13,34,46,-12,27
Dutch Eredivisie 2019/20,PEC Zwolle,26,7,5,14,37,55,-18,26
Dutch Eredivisie 2019/20,Fortuna Sittard,26,6,8,12,29,52,-23,26
Dutch Eredivisie 2019/20,ADO Den Haag,26,4,7,15,25,54,-29,19
Dutch Eredivisie 2019/20,RKC Waalwijk,26,4,3,19,27,60,-33,15
Dutch Eredivisie 2020/21,Ajax,7,6,0,1,29,5,24,18
Dutch Eredivisie 2020/21,Vitesse Arnhem,7,6,0,1,14,4,10,18
Dutch Eredivisie 2020/21,PSV Eindhoven,7,5,1,1,16,5,11,16
Dutch Eredivisie 2020/21,Heerenveen,7,5,1,1,16,8,8,16
Dutch Eredivisie 2020/21,Feyenoord,7,4,3,0,17,9,8,15
Dutch Eredivisie 2020/21,FC Twente,7,4,2,1,16,6,10,14
Dutch Eredivisie 2020/21,Groningen,7,4,1,2,9,8,1,13
Dutch Eredivisie 2020/21,FC Utrecht,6,2,3,1,8,8,0,9
Dutch Eredivisie 2020/21,AZ Alkmaar,6,1,5,0,15,12,3,8
Dutch Eredivisie 2020/21,Heracles Almelo,7,2,2,3,8,11,-3,8
Dutch Eredivisie 2020/21,PEC Zwolle,7,1,3,3,7,12,-5,6
Dutch Eredivisie 2020/21,Willem II,7,1,2,4,7,13,-6,5
Dutch Eredivisie 2020/21,RKC Waalwijk,7,1,2,4,5,13,-8,5
Dutch Eredivisie 2020/21,VVV-Venlo,7,1,2,4,10,24,-14,5
Dutch Eredivisie 2020/21,ADO Den Haag,7,1,1,5,6,16,-10,4
Dutch Eredivisie 2020/21,Emmen,7,0,3,4,10,18,-8,3
Dutch Eredivisie 2020/21,Sparta Rotterdam,7,0,3,4,7,17,-10,3
Dutch Eredivisie 2020/21,Fortuna Sittard,7,0,2,5,9,20,-11,2
European Championships - Group A 2008/09,Portugal *,3,2,0,1,5,3,2,6
European Championships - Group A 2008/09,Turkey *,3,2,0,1,5,5,0,6
European Championships - Group A 2008/09,Switzerland *,3,1,0,2,3,3,0,3
European Championships - Group A 2008/09,Czech Republic *,3,1,0,2,4,6,-2,3
European Championships - Group B 2008/09,Croatia *,3,3,0,0,4,1,3,9
European Championships - Group B 2008/09,Germany *,3,2,0,1,4,2,2,6
European Championships - Group B 2008/09,Austria *,3,0,1,2,1,3,-2,1
European Championships - Group B 2008/09,Poland *,3,0,1,2,1,4,-3,1
European Championships - Group C 2008/09,Netherlands *,3,3,0,0,9,1,8,9
European Championships - Group C 2008/09,Italy *,3,1,1,1,3,4,-1,4
European Championships - Group C 2008/09,Romania *,3,0,2,1,1,3,-2,2
European Championships - Group C 2008/09,France *,3,0,1,2,1,6,-5,1
European Championships - Group D 2008/09,Spain *,3,3,0,0,8,3,5,9
European Championships - Group D 2008/09,Russia *,3,2,0,1,4,4,0,6
European Championships - Group D 2008/09,Sweden *,3,1,0,2,3,4,-1,3
European Championships - Group D 2008/09,Greece *,3,0,0,3,1,5,-4,0
European Championships - Group A 2012/13,Czech Republic,3,2,0,1,4,5,-1,6
European Championships - Group A 2012/13,Greece,3,1,1,1,3,3,0,4
European Championships - Group A 2012/13,Russia,3,1,1,1,5,3,2,4
European Championships - Group A 2012/13,Poland,3,0,2,1,2,3,-1,2
European Championships - Group B 2012/13,Germany,3,3,0,0,5,2,3,9
European Championships - Group B 2012/13,Portugal,3,2,0,1,5,4,1,6
European Championships - Group B 2012/13,Denmark,3,1,0,2,4,5,-1,3
European Championships - Group B 2012/13,Netherlands,3,0,0,3,2,5,-3,0
European Championships - Group C 2012/13,Spain,3,2,1,0,6,1,5,7
European Championships - Group C 2012/13,Italy,3,1,2,0,4,2,2,5
European Championships - Group C 2012/13,Croatia,3,1,1,1,4,3,1,4
European Championships - Group C 2012/13,Republic of Ireland,3,0,0,3,1,9,-8,0
European Championships - Group D 2012/13,England,3,2,1,0,5,3,2,7
European Championships - Group D 2012/13,France,3,1,1,1,3,3,0,4
European Championships - Group D 2012/13,Ukraine,3,1,0,2,2,4,-2,3
European Championships - Group D 2012/13,Sweden,3,1,0,2,5,5,0,3
European Championships - Group A 2015/16,France,3,2,1,0,4,1,3,7
European Championships - Group A 2015/16,Switzerland,3,1,2,0,2,1,1,5
European Championships - Group A 2015/16,Albania,3,1,0,2,1,3,-2,3
European Championships - Group A 2015/16,Romania,3,0,1,2,2,4,-2,1
European Championships - Group B 2015/16,Wales,3,2,0,1,6,3,3,6
European Championships - Group B 2015/16,England,3,1,2,0,3,2,1,5
European Championships - Group B 2015/16,Slovakia,3,1,1,1,3,3,0,4
European Championships - Group B 2015/16,Russia,3,0,1,2,2,6,-4,1
European Championships - Group C 2015/16,Germany,3,2,1,0,3,0,3,7
European Championships - Group C 2015/16,Poland,3,2,1,0,2,0,2,7
European Championships - Group C 2015/16,Northern Ireland,3,1,0,2,2,2,0,3
European Championships - Group C 2015/16,Ukraine,3,0,0,3,0,5,-5,0
European Championships - Group D 2015/16,Croatia,3,2,1,0,5,3,2,7
European Championships - Group D 2015/16,Spain,3,2,0,1,5,2,3,6
European Championships - Group D 2015/16,Turkey,3,1,0,2,2,4,-2,3
European Championships - Group D 2015/16,Czech Republic,3,0,1,2,2,5,-3,1
European Championships - Group E 2015/16,Italy,3,2,0,1,3,1,2,6
European Championships - Group E 2015/16,Belgium,3,2,0,1,4,2,2,6
European Championships - Group E 2015/16,Republic of Ireland,3,1,1,1,2,4,-2,4
European Championships - Group E 2015/16,Sweden,3,0,1,2,1,3,-2,1
European Championships - Group F 2015/16,Hungary,3,1,2,0,6,4,2,5
European Championships - Group F 2015/16,Iceland,3,1,2,0,4,3,1,5
European Championships - Group F 2015/16,Portugal,3,0,3,0,4,4,0,3
European Championships - Group F 2015/16,Austria,3,0,1,2,1,4,-3,1
European Championships - Group A 2016/17,France,3,2,1,0,4,1,3,7
European Championships - Group A 2016/17,Switzerland,3,1,2,0,2,1,1,5
European Championships - Group A 2016/17,Albania,3,1,0,2,1,3,-2,3
European Championships - Group A 2016/17,Romania,3,0,1,2,2,4,-2,1
European Championships - Group B 2016/17,Wales,3,2,0,1,6,3,3,6
European Championships - Group B 2016/17,England,3,1,2,0,3,2,1,5
European Championships - Group B 2016/17,Slovakia,3,1,1,1,3,3,0,4
European Championships - Group B 2016/17,Russia,3,0,1,2,2,6,-4,1
European Championships - Group C 2016/17,Germany,3,2,1,0,3,0,3,7
European Championships - Group C 2016/17,Poland,3,2,1,0,2,0,2,7
European Championships - Group C 2016/17,Northern Ireland,3,1,0,2,2,2,0,3
European Championships - Group C 2016/17,Ukraine,3,0,0,3,0,5,-5,0
European Championships - Group D 2016/17,Croatia,3,2,1,0,5,3,2,7
European Championships - Group D 2016/17,Spain,3,2,0,1,5,2,3,6
European Championships - Group D 2016/17,Turkey,3,1,0,2,2,4,-2,3
European Championships - Group D 2016/17,Czech Republic,3,0,1,2,2,5,-3,1
European Championships - Group E 2016/17,Italy,3,2,0,1,3,1,2,6
European Championships - Group E 2016/17,Belgium,3,2,0,1,4,2,2,6
European Championships - Group E 2016/17,Republic of Ireland,3,1,1,1,2,4,-2,4
European Championships - Group E 2016/17,Sweden,3,0,1,2,1,3,-2,1
European Championships - Group F 2016/17,Hungary,3,1,2,0,6,4,2,5
European Championships - Group F 2016/17,Iceland,3,1,2,0,4,3,1,5
European Championships - Group F 2016/17,Portugal,3,0,3,0,4,4,0,3
European Championships - Group F 2016/17,Austria,3,0,1,2,1,4,-3,1
European Championships - Group A 2019/20,Italy,0,0,0,0,0,0,0,0
European Championships - Group A 2019/20,Switzerland,0,0,0,0,0,0,0,0
European Championships - Group A 2019/20,Turkey,0,0,0,0,0,0,0,0
European Championships - Group A 2019/20,Wales,0,0,0,0,0,0,0,0
European Championships - Group B 2019/20,Belgium,0,0,0,0,0,0,0,0
European Championships - Group B 2019/20,Denmark,0,0,0,0,0,0,0,0
European Championships - Group B 2019/20,Finland,0,0,0,0,0,0,0,0
European Championships - Group B 2019/20,Russia,0,0,0,0,0,0,0,0
European Championships - Group C 2019/20,Austria,0,0,0,0,0,0,0,0
European Championships - Group C 2019/20,Netherlands,0,0,0,0,0,0,0,0
European Championships - Group C 2019/20,Ukraine,0,0,0,0,0,0,0,0
European Championships - Group C 2019/20,Winner play-off Path D,0,0,0,0,0,0,0,0
European Championships - Group D 2019/20,Croatia,0,0,0,0,0,0,0,0
European Championships - Group D 2019/20,Czech Republic,0,0,0,0,0,0,0,0
European Championships - Group D 2019/20,England,0,0,0,0,0,0,0,0
European Championships - Group D 2019/20,Winner play-off Path C,0,0,0,0,0,0,0,0
European Championships - Group E 2019/20,Poland,0,0,0,0,0,0,0,0
European Championships - Group E 2019/20,Spain,0,0,0,0,0,0,0,0
European Championships - Group E 2019/20,Sweden,0,0,0,0,0,0,0,0
European Championships - Group E 2019/20,Winner play-off Path B,0,0,0,0,0,0,0,0
European Championships - Group F 2019/20,France,0,0,0,0,0,0,0,0
European Championships - Group F 2019/20,Germany,0,0,0,0,0,0,0,0
European Championships - Group F 2019/20,Portugal,0,0,0,0,0,0,0,0
European Championships - Group F 2019/20,Winner play-off Path A,0,0,0,0,0,0,0,0
Europa League - Group A 2009/10,Anderlecht,6,3,2,1,9,4,5,11
Europa League - Group A 2009/10,Ajax,6,3,2,1,8,6,2,11
Europa League - Group A 2009/10,Dinamo Zagreb,6,2,0,4,6,8,-2,6
Europa League - Group A 2009/10,Politehnica Timisoara,6,1,2,3,4,9,-5,5
Europa League - Group B 2009/10,Valencia,6,3,3,0,12,8,4,12
Europa League - Group B 2009/10,Lille,6,3,1,2,15,9,6,10
Europa League - Group B 2009/10,Genoa,6,2,1,3,8,10,-2,7
Europa League - Group B 2009/10,Slavia Prague,6,0,3,3,5,13,-8,3
Europa League - Group C 2009/10,Hapoel Tel-Aviv,6,4,0,2,13,8,5,12
Europa League - Group C 2009/10,Hamburg,6,3,1,2,7,6,1,10
Europa League - Group C 2009/10,Celtic,6,1,3,2,7,7,0,6
Europa League - Group C 2009/10,Rapid Wien,6,1,2,3,8,14,-6,5
Europa League - Group D 2009/10,Sporting Lisbon,6,3,2,1,8,6,2,11
Europa League - Group D 2009/10,Hertha Berlin,6,3,1,2,6,5,1,10
Europa League - Group D 2009/10,Heerenveen,6,2,2,2,11,7,4,8
Europa League - Group D 2009/10,FK Ventspils,6,0,3,3,3,10,-7,3
Europa League - Group E 2009/10,Roma,6,4,1,1,10,5,5,13
Europa League - Group E 2009/10,Fulham,6,3,2,1,8,6,2,11
Europa League - Group E 2009/10,Basel,6,3,0,3,10,7,3,9
Europa League - Group E 2009/10,CSKA Sofia,6,0,1,5,2,12,-10,1
Europa League - Group F 2009/10,Galatasaray,6,4,1,1,12,4,8,13
Europa League - Group F 2009/10,Panathinaikos,6,4,0,2,7,4,3,12
Europa League - Group F 2009/10,FC Dinamo Bucuresti,6,2,0,4,4,12,-8,6
Europa League - Group F 2009/10,Sturm Graz,6,1,1,4,3,6,-3,4
Europa League - Group G 2009/10,Red Bull Salzburg,6,6,0,0,9,2,7,18
Europa League - Group G 2009/10,Villarreal,6,3,0,3,8,6,2,9
Europa League - Group G 2009/10,Lazio,6,2,0,4,9,10,-1,6
Europa League - Group G 2009/10,Levski Sofia,6,1,0,5,1,9,-8,3
Europa League - Group H 2009/10,Fenerbahce,6,5,0,1,8,3,5,15
Europa League - Group H 2009/10,FC Twente,6,2,2,2,5,6,-1,8
Europa League - Group H 2009/10,Sheriff Tiraspol (Mol),6,1,2,3,4,5,-1,5
Europa League - Group H 2009/10,FC Steaua Bucuresti,6,0,4,2,3,6,-3,4
Europa League - Group I 2009/10,Benfica,6,5,0,1,13,3,10,15
Europa League - Group I 2009/10,Everton,6,3,0,3,7,9,-2,9
Europa League - Group I 2009/10,BATE Borisov,6,2,1,3,7,9,-2,7
Europa League - Group I 2009/10,AEK Athens,6,1,1,4,5,11,-6,4
Europa League - Group J 2009/10,Shakhtar Donetsk,6,4,1,1,14,3,11,13
Europa League - Group J 2009/10,Club Brugge,6,3,2,1,10,8,2,11
Europa League - Group J 2009/10,Toulouse,6,2,1,3,6,11,-5,7
Europa League - Group J 2009/10,Partizan Belgrade,6,1,0,5,6,14,-8,3
Europa League - Group K 2009/10,PSV Eindhoven,6,4,2,0,8,3,5,14
Europa League - Group K 2009/10,FC Copenhagen,6,3,1,2,7,4,3,10
Europa League - Group K 2009/10,Sparta Prague,6,2,1,3,7,9,-2,7
Europa League - Group K 2009/10,CFR Cluj-Napoca,6,1,0,5,4,10,-6,3
Europa League - Group L 2009/10,Werder Bremen,6,5,1,0,17,6,11,16
Europa League - Group L 2009/10,Athletic Bilbao,6,3,1,2,10,8,2,10
Europa League - Group L 2009/10,Nacional,6,1,2,3,11,12,-1,5
Europa League - Group L 2009/10,FK Austria Wien,6,0,2,4,4,16,-12,2
Europa League - Group A 2010/11,Manchester City,6,3,2,1,11,6,5,11
Europa League - Group A 2010/11,Lech Poznan,6,3,2,1,11,8,3,11
Europa League - Group A 2010/11,Juventus,6,0,6,0,7,7,0,6
Europa League - Group A 2010/11,Red Bull Salzburg,6,0,2,4,1,9,-8,2
Europa League - Group B 2010/11,Bayer Leverkusen,6,3,3,0,8,2,6,12
Europa League - Group B 2010/11,Aris Salonika,6,3,1,2,7,5,2,10
Europa League - Group B 2010/11,Atletico Madrid,6,2,2,2,9,7,2,8
Europa League - Group B 2010/11,Rosenborg,6,1,0,5,3,13,-10,3
Europa League - Group C 2010/11,Sporting Lisbon,6,4,0,2,14,6,8,12
Europa League - Group C 2010/11,Lille,6,2,2,2,8,6,2,8
Europa League - Group C 2010/11,AA Gent,6,2,1,3,8,13,-5,7
Europa League - Group C 2010/11,Levski Sofia,6,2,1,3,6,11,-5,7
Europa League - Group D 2010/11,Villarreal,6,4,0,2,8,5,3,12
Europa League - Group D 2010/11,PAOK Salonika,6,3,2,1,5,3,2,11
Europa League - Group D 2010/11,Dinamo Zagreb,6,2,1,3,4,5,-1,7
Europa League - Group D 2010/11,Club Brugge,6,0,3,3,4,8,-4,3
Europa League - Group E 2010/11,Dynamo Kiev,6,3,2,1,10,6,4,11
Europa League - Group E 2010/11,BATE Borisov,6,3,1,2,11,11,0,10
Europa League - Group E 2010/11,AZ Alkmaar,6,2,1,3,8,10,-2,7
Europa League - Group E 2010/11,Sheriff Tiraspol (Mol),6,1,2,3,5,7,-2,5
Europa League - Group F 2010/11,CSKA Moscow,6,5,1,0,18,3,15,16
Europa League - Group F 2010/11,Sparta Prague,6,2,3,1,12,12,0,9
Europa League - Group F 2010/11,Palermo,6,2,1,3,7,11,-4,7
Europa League - Group F 2010/11,Lausanne Sports,6,0,1,5,5,16,-11,1
Europa League - Group G 2010/11,Zenit St. Petersburg,6,6,0,0,18,6,12,18
Europa League - Group G 2010/11,Anderlecht,6,2,1,3,8,8,0,7
Europa League - Group G 2010/11,AEK Athens,6,2,1,3,9,13,-4,7
Europa League - Group G 2010/11,Hajduk Split,6,1,0,5,5,13,-8,3
Europa League - Group H 2010/11,Stuttgart,6,5,0,1,16,6,10,15
Europa League - Group H 2010/11,BSC Young Boys Bern,6,3,0,3,10,10,0,9
Europa League - Group H 2010/11,Getafe,6,2,1,3,4,8,-4,7
Europa League - Group H 2010/11,OB Odense,6,1,1,4,8,14,-6,4
Europa League - Group I 2010/11,PSV Eindhoven,6,4,2,0,10,3,7,14
Europa League - Group I 2010/11,Metalist Kharkiv,6,3,2,1,9,4,5,11
Europa League - Group I 2010/11,Sampdoria,6,1,2,3,4,7,-3,5
Europa League - Group I 2010/11,Debreceni Vasutas Sport Club,6,1,0,5,4,13,-9,3
Europa League - Group J 2010/11,Paris Saint-Germain,6,3,3,0,9,4,5,12
Europa League - Group J 2010/11,Sevilla,6,3,1,2,10,7,3,10
Europa League - Group J 2010/11,Borussia Dortmund,6,2,3,1,10,7,3,9
Europa League - Group J 2010/11,Karpaty Lviv,6,0,1,5,4,15,-11,1
Europa League - Group K 2010/11,Liverpool,6,2,4,0,8,3,5,10
Europa League - Group K 2010/11,Napoli,6,1,4,1,8,9,-1,7
Europa League - Group K 2010/11,FC Steaua Bucuresti,6,1,3,2,9,11,-2,6
Europa League - Group K 2010/11,FC Utrecht,6,0,5,1,5,7,-2,5
Europa League - Group L 2010/11,FC Porto,6,5,1,0,14,4,10,16
Europa League - Group L 2010/11,Besiktas,6,4,1,1,9,6,3,13
Europa League - Group L 2010/11,Rapid Wien,6,1,0,5,5,12,-7,3
Europa League - Group L 2010/11,CSKA Sofia,6,1,0,5,4,10,-6,3
Europa League - Group A 2011/12,PAOK Salonika,6,3,3,0,10,6,4,12
Europa League - Group A 2011/12,Rubin Kazan,6,3,2,1,11,5,6,11
Europa League - Group A 2011/12,Tottenham Hotspur,6,3,1,2,9,4,5,10
Europa League - Group A 2011/12,Shamrock Rovers,6,0,0,6,4,19,-15,0
Europa League - Group B 2011/12,Standard Liege,6,4,2,0,9,1,8,14
Europa League - Group B 2011/12,Hannover 96,6,3,2,1,9,7,2,11
Europa League - Group B 2011/12,FC Copenhagen,6,1,2,3,5,9,-4,5
Europa League - Group B 2011/12,Vorskla,6,0,2,4,4,10,-6,2
Europa League - Group C 2011/12,PSV Eindhoven,6,5,1,0,13,5,8,16
Europa League - Group C 2011/12,Legia Warsaw,6,3,0,3,7,9,-2,9
Europa League - Group C 2011/12,Hapoel Tel-Aviv,6,2,1,3,10,9,1,7
Europa League - Group C 2011/12,FC Rapid Bucuresti,6,1,0,5,5,12,-7,3
Europa League - Group D 2011/12,Sporting Lisbon,6,4,0,2,8,4,4,12
Europa League - Group D 2011/12,Lazio,6,2,3,1,7,5,2,9
Europa League - Group D 2011/12,FC Vaslui,6,1,3,2,5,8,-3,6
Europa League - Group D 2011/12,FC Zurich,6,1,2,3,5,8,-3,5
Europa League - Group E 2011/12,Besiktas,6,4,0,2,13,7,6,12
Europa League - Group E 2011/12,Stoke City,6,3,2,1,10,7,3,11
Europa League - Group E 2011/12,Dynamo Kiev,6,1,4,1,7,7,0,7
Europa League - Group E 2011/12,Maccabi Tel Aviv,6,0,2,4,8,17,-9,2
Europa League - Group F 2011/12,Athletic Bilbao,6,4,1,1,11,8,3,13
Europa League - Group F 2011/12,Red Bull Salzburg,6,3,1,2,11,8,3,10
Europa League - Group F 2011/12,Paris Saint-Germain,6,3,1,2,8,7,1,10
Europa League - Group F 2011/12,SK Slovan Bratislava,6,0,1,5,4,11,-7,1
Europa League - Group G 2011/12,Metalist Kharkiv,6,4,2,0,15,6,9,14
Europa League - Group G 2011/12,AZ Alkmaar,6,1,5,0,10,7,3,8
Europa League - Group G 2011/12,FK Austria Wien,6,2,2,2,10,11,-1,8
Europa League - Group G 2011/12,Malmo FF,6,0,1,5,4,15,-11,1
Europa League - Group H 2011/12,Club Brugge,6,3,2,1,12,9,3,11
Europa League - Group H 2011/12,Braga,6,3,2,1,12,6,6,11
Europa League - Group H 2011/12,Birmingham City,6,3,1,2,8,8,0,10
Europa League - Group H 2011/12,Maribor,6,0,1,5,6,15,-9,1
Europa League - Group I 2011/12,Atletico Madrid,6,4,1,1,11,4,7,13
Europa League - Group I 2011/12,Udinese,6,2,3,1,6,7,-1,9
Europa League - Group I 2011/12,Celtic,6,1,3,2,6,7,-1,6
Europa League - Group I 2011/12,Rennes,6,0,3,3,5,10,-5,3
Europa League - Group J 2011/12,Schalke,6,4,2,0,13,2,11,14
Europa League - Group J 2011/12,FC Steaua Bucuresti,6,2,2,2,9,11,-2,8
Europa League - Group J 2011/12,Maccabi Haifa (Isr),6,2,0,4,10,12,-2,6
Europa League - Group J 2011/12,AEK XI,6,1,2,3,4,11,-7,5
Europa League - Group K 2011/12,FC Twente,6,4,1,1,14,7,7,13
Europa League - Group K 2011/12,Wisla Krakow,6,3,0,3,8,13,-5,9
Europa League - Group K 2011/12,Fulham,6,2,2,2,9,6,3,8
Europa League - Group K 2011/12,OB Odense,6,1,1,4,9,14,-5,4
Europa League - Group L 2011/12,Anderlecht,6,6,0,0,18,5,13,18
Europa League - Group L 2011/12,Lokomotiv Moscow,6,4,0,2,14,11,3,12
Europa League - Group L 2011/12,AEK Athens,6,1,0,5,8,15,-7,3
Europa League - Group L 2011/12,Sturm Graz,6,1,0,5,5,14,-9,3
Europa League - Group A 2012/13,Liverpool,6,3,1,2,11,9,2,10
Europa League - Group A 2012/13,Anzhi Makhachkala,6,3,1,2,7,5,2,10
Europa League - Group A 2012/13,BSC Young Boys Bern,6,3,1,2,14,13,1,10
Europa League - Group A 2012/13,Udinese,6,1,1,4,7,12,-5,4
Europa League - Group B 2012/13,FC Viktoria Plzen,6,4,1,1,11,4,7,13
Europa League - Group B 2012/13,Atletico Madrid,6,4,0,2,7,4,3,12
Europa League - Group B 2012/13,Academica,6,1,2,3,6,9,-3,5
Europa League - Group B 2012/13,Hapoel Tel-Aviv,6,1,1,4,4,11,-7,4
Europa League - Group C 2012/13,Fenerbahce,6,4,1,1,10,7,3,13
Europa League - Group C 2012/13,M'gladbach,6,3,2,1,11,6,5,11
Europa League - Group C 2012/13,Marseille,6,1,2,3,9,11,-2,5
Europa League - Group C 2012/13,AEL,6,1,1,4,4,10,-6,4
Europa League - Group D 2012/13,Bordeaux,6,4,1,1,10,5,5,13
Europa League - Group D 2012/13,Newcastle United,6,2,3,1,7,5,2,9
Europa League - Group D 2012/13,Maritimo,6,1,3,2,4,6,-2,6
Europa League - Group D 2012/13,Club Brugge,6,1,1,4,6,11,-5,4
Europa League - Group E 2012/13,FC Steaua Bucuresti,6,3,2,1,9,9,0,11
Europa League - Group E 2012/13,Stuttgart,6,2,2,2,9,6,3,8
Europa League - Group E 2012/13,FC Copenhagen,6,2,2,2,5,6,-1,8
Europa League - Group E 2012/13,Molde,6,2,0,4,6,8,-2,6
Europa League - Group F 2012/13,Dnipro,6,5,0,1,16,8,8,15
Europa League - Group F 2012/13,Napoli,6,3,0,3,12,12,0,9
Europa League - Group F 2012/13,PSV Eindhoven,6,2,1,3,8,7,1,7
Europa League - Group F 2012/13,AIK,6,1,1,4,5,14,-9,4
Europa League - Group G 2012/13,Genk,6,3,3,0,9,4,5,12
Europa League - Group G 2012/13,Basel,6,2,3,1,7,4,3,9
Europa League - Group G 2012/13,MOL Vidi FC,6,2,0,4,6,8,-2,6
Europa League - Group G 2012/13,Sporting Lisbon,6,1,2,3,4,10,-6,5
Europa League - Group H 2012/13,Rubin Kazan,6,4,2,0,10,3,7,14
Europa League - Group H 2012/13,Inter Milan,6,3,2,1,11,9,2,11
Europa League - Group H 2012/13,Partizan Belgrade,6,0,3,3,3,8,-5,3
Europa League - Group H 2012/13,FC Neftchi,6,0,3,3,4,8,-4,3
Europa League - Group I 2012/13,Lyon,6,5,1,0,14,8,6,16
Europa League - Group I 2012/13,Sparta Prague,6,2,3,1,9,6,3,9
Europa League - Group I 2012/13,Athletic Bilbao,6,1,2,3,7,9,-2,5
Europa League - Group I 2012/13,Hapoel Kiryat Shmona,6,0,2,4,6,13,-7,2
Europa League - Group J 2012/13,Lazio,6,3,3,0,9,2,7,12
Europa League - Group J 2012/13,Tottenham Hotspur,6,2,4,0,8,4,4,10
Europa League - Group J 2012/13,Panathinaikos,6,1,2,3,4,11,-7,5
Europa League - Group J 2012/13,Maribor,6,1,1,4,6,10,-4,4
Europa League - Group K 2012/13,Metalist Kharkiv,6,4,1,1,9,3,6,13
Europa League - Group K 2012/13,Bayer Leverkusen,6,4,1,1,9,2,7,13
Europa League - Group K 2012/13,Rosenborg,6,2,0,4,7,10,-3,6
Europa League - Group K 2012/13,Rapid Wien,6,1,0,5,4,14,-10,3
Europa League - Group L 2012/13,Hannover 96,6,3,3,0,11,8,3,12
Europa League - Group L 2012/13,Levante,6,3,2,1,10,5,5,11
Europa League - Group L 2012/13,Helsingborgs IF,6,1,1,4,9,12,-3,4
Europa League - Group L 2012/13,FC Twente,6,0,4,2,5,10,-5,4
Europa League - Group A 2013/14,Valencia,6,4,1,1,12,7,5,13
Europa League - Group A 2013/14,Swansea City,6,2,2,2,6,4,2,8
Europa League - Group A 2013/14,Kuban,6,1,3,2,7,7,0,6
Europa League - Group A 2013/14,St Gallen,6,2,0,4,6,13,-7,6
Europa League - Group B 2013/14,Ludogorets,6,5,1,0,11,2,9,16
Europa League - Group B 2013/14,Chernomorets Odessa,6,3,1,2,6,6,0,10
Europa League - Group B 2013/14,PSV Eindhoven,6,2,1,3,4,5,-1,7
Europa League - Group B 2013/14,Dinamo Zagreb,6,0,1,5,3,11,-8,1
Europa League - Group C 2013/14,Red Bull Salzburg,6,6,0,0,15,3,12,18
Europa League - Group C 2013/14,Esbjerg,6,4,0,2,8,8,0,12
Europa League - Group C 2013/14,IF Elfsborg,6,1,1,4,5,10,-5,4
Europa League - Group C 2013/14,Standard Liege,6,0,1,5,6,13,-7,1
Europa League - Group D 2013/14,Rubin Kazan,6,4,2,0,14,4,10,14
Europa League - Group D 2013/14,Maribor,6,2,1,3,9,12,-3,7
Europa League - Group D 2013/14,Zulte-Waregem,6,2,1,3,4,10,-6,7
Europa League - Group D 2013/14,Wigan Athletic,6,1,2,3,6,7,-1,5
Europa League - Group E 2013/14,Fiorentina,6,5,1,0,12,3,9,16
Europa League - Group E 2013/14,Dnipro,6,4,0,2,11,5,6,12
Europa League - Group E 2013/14,Pacos Ferreira,6,0,3,3,1,8,-7,3
Europa League - Group E 2013/14,Pandurii Targu-Jiu,6,0,2,4,3,11,-8,2
Europa League - Group F 2013/14,Eintracht Frankfurt,6,5,0,1,13,4,9,15
Europa League - Group F 2013/14,Maccabi Tel Aviv,6,3,2,1,7,5,2,11
Europa League - Group F 2013/14,Apoel Nicosia,6,1,2,3,3,8,-5,5
Europa League - Group F 2013/14,Bordeaux,6,1,0,5,4,10,-6,3
Europa League - Group G 2013/14,Genk,6,4,2,0,10,5,5,14
Europa League - Group G 2013/14,Dynamo Kiev,6,3,1,2,11,7,4,10
Europa League - Group G 2013/14,Rapid Wien,6,1,3,2,8,10,-2,6
Europa League - Group G 2013/14,FC Thun,6,1,0,5,3,10,-7,3
Europa League - Group H 2013/14,Sevilla,6,3,3,0,9,4,5,12
Europa League - Group H 2013/14,Slovan Liberec,6,2,3,1,9,8,1,9
Europa League - Group H 2013/14,SC Freiburg,6,1,3,2,5,8,-3,6
Europa League - Group H 2013/14,Estoril,6,0,3,3,5,8,-3,3
Europa League - Group I 2013/14,Lyon,6,3,3,0,6,3,3,12
Europa League - Group I 2013/14,Real Betis,6,2,3,1,3,2,1,9
Europa League - Group I 2013/14,Vitoria de Guimaraes,6,1,2,3,6,5,1,5
Europa League - Group I 2013/14,Rijeka,6,0,4,2,2,7,-5,4
Europa League - Group J 2013/14,Trabzonspor,6,4,2,0,13,6,7,14
Europa League - Group J 2013/14,Lazio,6,3,3,0,8,4,4,12
Europa League - Group J 2013/14,Apollon Limassol,6,1,1,4,5,10,-5,4
Europa League - Group J 2013/14,Legia Warsaw,6,1,0,5,2,8,-6,3
Europa League - Group K 2013/14,Tottenham Hotspur,6,6,0,0,15,2,13,18
Europa League - Group K 2013/14,Anzhi Makhachkala,6,2,2,2,4,7,-3,8
Europa League - Group K 2013/14,Sheriff Tiraspol (Mol),6,1,3,2,5,6,-1,6
Europa League - Group K 2013/14,Tromso,6,0,1,5,1,10,-9,1
Europa League - Group L 2013/14,AZ Alkmaar,6,3,3,0,8,4,4,12
Europa League - Group L 2013/14,PAOK Salonika,6,3,3,0,10,6,4,12
Europa League - Group L 2013/14,Maccabi Haifa (Isr),6,1,2,3,6,9,-3,5
Europa League - Group L 2013/14,Shakhtyor Karaganda,6,0,2,4,5,10,-5,2
Europa League - Group A 2014/15,M'gladbach,6,3,3,0,14,4,10,12
Europa League - Group A 2014/15,Villarreal,6,3,2,1,15,7,8,11
Europa League - Group A 2014/15,FC Zurich,6,2,1,3,10,14,-4,7
Europa League - Group A 2014/15,Apollon Limassol,6,1,0,5,4,18,-14,3
Europa League - Group B 2014/15,Club Brugge,6,3,3,0,10,2,8,12
Europa League - Group B 2014/15,Torino,6,3,2,1,9,3,6,11
Europa League - Group B 2014/15,HJK Helsinki,6,2,0,4,5,11,-6,6
Europa League - Group B 2014/15,FC Copenhagen,6,1,1,4,5,13,-8,4
Europa League - Group C 2014/15,Besiktas,6,3,3,0,11,5,6,12
Europa League - Group C 2014/15,Tottenham Hotspur,6,3,2,1,9,4,5,11
Europa League - Group C 2014/15,Asteras Tripoli,6,1,3,2,7,10,-3,6
Europa League - Group C 2014/15,Partizan Belgrade,6,0,2,4,1,9,-8,2
Europa League - Group D 2014/15,Red Bull Salzburg,6,5,1,0,21,8,13,16
Europa League - Group D 2014/15,Celtic,6,2,2,2,10,11,-1,8
Europa League - Group D 2014/15,Dinamo Zagreb,6,2,0,4,12,15,-3,6
Europa League - Group D 2014/15,FC Astra Giurgiu,6,1,1,4,6,15,-9,4
Europa League - Group E 2014/15,Dynamo Moscow,6,6,0,0,9,3,6,18
Europa League - Group E 2014/15,PSV Eindhoven,6,2,2,2,8,8,0,8
Europa League - Group E 2014/15,Estoril,6,1,2,3,7,8,-1,5
Europa League - Group E 2014/15,Panathinaikos,6,0,2,4,6,11,-5,2
Europa League - Group F 2014/15,Inter Milan,6,3,3,0,6,2,4,12
Europa League - Group F 2014/15,Dnipro,6,2,1,3,4,5,-1,7
Europa League - Group F 2014/15,Qarabag FK,6,1,3,2,3,5,-2,6
Europa League - Group F 2014/15,St Etienne,6,0,5,1,2,3,-1,5
Europa League - Group G 2014/15,Feyenoord,6,4,0,2,10,6,4,12
Europa League - Group G 2014/15,Sevilla,6,3,2,1,8,5,3,11
Europa League - Group G 2014/15,Rijeka,6,2,1,3,7,8,-1,7
Europa League - Group G 2014/15,Standard Liege,6,1,1,4,4,10,-6,4
Europa League - Group H 2014/15,Everton,6,3,2,1,10,3,7,11
Europa League - Group H 2014/15,Wolfsburg,6,3,1,2,14,10,4,10
Europa League - Group H 2014/15,Krasnodar,6,1,3,2,7,12,-5,6
Europa League - Group H 2014/15,Lille,6,0,4,2,3,9,-6,4
Europa League - Group I 2014/15,Napoli,6,4,1,1,11,3,8,13
Europa League - Group I 2014/15,BSC Young Boys Bern,6,4,0,2,13,7,6,12
Europa League - Group I 2014/15,Sparta Prague,6,3,1,2,11,6,5,10
Europa League - Group I 2014/15,SK Slovan Bratislava,6,0,0,6,1,20,-19,0
Europa League - Group J 2014/15,Dynamo Kiev,6,5,0,1,12,4,8,15
Europa League - Group J 2014/15,Aalborg BK,6,3,0,3,5,10,-5,9
Europa League - Group J 2014/15,FC Steaua Bucuresti,6,2,1,3,11,9,2,7
Europa League - Group J 2014/15,Rio Ave,6,1,1,4,5,10,-5,4
Europa League - Group K 2014/15,Fiorentina,6,4,1,1,11,4,7,13
Europa League - Group K 2014/15,Guingamp,6,3,1,2,7,6,1,10
Europa League - Group K 2014/15,PAOK Salonika,6,2,1,3,10,7,3,7
Europa League - Group K 2014/15,Dinamo Minsk,6,1,1,4,3,14,-11,4
Europa League - Group L 2014/15,Legia Warsaw,6,5,0,1,7,2,5,15
Europa League - Group L 2014/15,Trabzonspor,6,3,1,2,8,6,2,10
Europa League - Group L 2014/15,Lokeren SNW,6,3,1,2,4,4,0,10
Europa League - Group L 2014/15,Metalist Kharkiv,6,0,0,6,3,10,-7,0
Europa League - Group A 2015/16,Molde,6,3,2,1,10,7,3,11
Europa League - Group A 2015/16,Fenerbahce,6,2,3,1,7,6,1,9
Europa League - Group A 2015/16,Ajax,6,1,4,1,6,6,0,7
Europa League - Group A 2015/16,Celtic,6,0,3,3,8,12,-4,3
Europa League - Group B 2015/16,Liverpool,6,2,4,0,6,4,2,10
Europa League - Group B 2015/16,FC Sion,6,2,3,1,5,5,0,9
Europa League - Group B 2015/16,Rubin Kazan,6,1,3,2,6,6,0,6
Europa League - Group B 2015/16,Bordeaux,6,0,4,2,5,7,-2,4
Europa League - Group C 2015/16,Krasnodar,6,4,1,1,9,4,5,13
Europa League - Group C 2015/16,Borussia Dortmund,6,3,1,2,10,5,5,10
Europa League - Group C 2015/16,PAOK Salonika,6,1,4,1,3,3,0,7
Europa League - Group C 2015/16,FK Qabala,6,0,2,4,2,12,-10,2
Europa League - Group D 2015/16,Napoli,6,6,0,0,22,3,19,18
Europa League - Group D 2015/16,FC Midtjylland,6,2,1,3,6,12,-6,7
Europa League - Group D 2015/16,Club Brugge,6,1,2,3,4,11,-7,5
Europa League - Group D 2015/16,Legia Warsaw,6,1,1,4,4,10,-6,4
Europa League - Group E 2015/16,Rapid Wien,6,5,0,1,10,6,4,15
Europa League - Group E 2015/16,Villarreal,6,4,1,1,12,6,6,13
Europa League - Group E 2015/16,FC Viktoria Plzen,6,1,1,4,8,10,-2,4
Europa League - Group E 2015/16,Dinamo Minsk,6,1,0,5,3,11,-8,3
Europa League - Group F 2015/16,Braga,6,4,1,1,7,4,3,13
Europa League - Group F 2015/16,Marseille,6,4,0,2,12,7,5,12
Europa League - Group F 2015/16,Slovan Liberec,6,2,1,3,6,8,-2,7
Europa League - Group F 2015/16,Groningen,6,0,2,4,2,8,-6,2
Europa League - Group G 2015/16,Lazio,6,4,2,0,13,6,7,14
Europa League - Group G 2015/16,St Etienne,6,2,3,1,10,7,3,9
Europa League - Group G 2015/16,Dnipro,6,2,1,3,6,8,-2,7
Europa League - Group G 2015/16,Rosenborg,6,0,2,4,4,12,-8,2
Europa League - Group H 2015/16,Lokomotiv Moscow,6,3,2,1,12,7,5,11
Europa League - Group H 2015/16,Sporting Lisbon,6,3,1,2,14,11,3,10
Europa League - Group H 2015/16,Besiktas,6,2,3,1,7,6,1,9
Europa League - Group H 2015/16,Skenderbeu,6,1,0,5,4,13,-9,3
Europa League - Group I 2015/16,Basel,6,4,1,1,10,5,5,13
Europa League - Group I 2015/16,Fiorentina,6,3,1,2,11,6,5,10
Europa League - Group I 2015/16,Lech Poznan,6,1,2,3,2,6,-4,5
Europa League - Group I 2015/16,Belenenses,6,1,2,3,2,8,-6,5
Europa League - Group J 2015/16,Tottenham Hotspur,6,4,1,1,12,6,6,13
Europa League - Group J 2015/16,Anderlecht,6,3,1,2,8,6,2,10
Europa League - Group J 2015/16,Monaco,6,1,3,2,5,9,-4,6
Europa League - Group J 2015/16,Qarabag FK,6,1,1,4,4,8,-4,4
Europa League - Group K 2015/16,Schalke,6,4,2,0,15,3,12,14
Europa League - Group K 2015/16,Sparta Prague,6,3,3,0,10,5,5,12
Europa League - Group K 2015/16,Asteras Tripoli,6,1,1,4,4,12,-8,4
Europa League - Group K 2015/16,Apoel Nicosia,6,1,0,5,3,12,-9,3
Europa League - Group L 2015/16,Athletic Bilbao,6,4,1,1,16,8,8,13
Europa League - Group L 2015/16,FC Augsburg,6,3,0,3,12,11,1,9
Europa League - Group L 2015/16,Partizan Belgrade,6,3,0,3,10,14,-4,9
Europa League - Group L 2015/16,AZ Alkmaar,6,1,1,4,8,13,-5,4
Europa League - Group A 2016/17,Fenerbahce,6,4,1,1,8,6,2,13
Europa League - Group A 2016/17,Manchester United,6,4,0,2,12,4,8,12
Europa League - Group A 2016/17,Feyenoord,6,2,1,3,3,7,-4,7
Europa League - Group A 2016/17,FC Zorya Luhansk,6,0,2,4,2,8,-6,2
Europa League - Group B 2016/17,Apoel Nicosia,6,4,0,2,8,6,2,12
Europa League - Group B 2016/17,Olympiakos FC,6,2,2,2,7,6,1,8
Europa League - Group B 2016/17,BSC Young Boys Bern,6,2,2,2,7,4,3,8
Europa League - Group B 2016/17,Astana,6,1,2,3,5,11,-6,5
Europa League - Group C 2016/17,St Etienne,6,3,3,0,8,5,3,12
Europa League - Group C 2016/17,Anderlecht,6,3,2,1,16,8,8,11
Europa League - Group C 2016/17,Mainz,6,2,3,1,8,10,-2,9
Europa League - Group C 2016/17,FK Qabala,6,0,0,6,5,14,-9,0
Europa League - Group D 2016/17,Zenit St. Petersburg,6,5,0,1,17,8,9,15
Europa League - Group D 2016/17,AZ Alkmaar,6,2,2,2,6,10,-4,8
Europa League - Group D 2016/17,Maccabi Tel Aviv,6,2,1,3,7,9,-2,7
Europa League - Group D 2016/17,Dundalk,6,1,1,4,5,8,-3,4
Europa League - Group E 2016/17,Roma,6,3,3,0,16,7,9,12
Europa League - Group E 2016/17,FC Astra Giurgiu,6,2,2,2,7,10,-3,8
Europa League - Group E 2016/17,FC Viktoria Plzen,6,1,3,2,7,10,-3,6
Europa League - Group E 2016/17,FK Austria Wien,6,1,2,3,11,14,-3,5
Europa League - Group F 2016/17,Genk,6,4,0,2,13,9,4,12
Europa League - Group F 2016/17,Athletic Bilbao,6,3,1,2,10,11,-1,10
Europa League - Group F 2016/17,Rapid Wien,6,1,3,2,7,8,-1,6
Europa League - Group F 2016/17,Sassuolo,6,1,2,3,9,11,-2,5
Europa League - Group G 2016/17,Ajax,6,4,2,0,11,6,5,14
Europa League - Group G 2016/17,Celta Vigo,6,2,3,1,10,7,3,9
Europa League - Group G 2016/17,Standard Liege,6,1,4,1,8,6,2,7
Europa League - Group G 2016/17,Panathinaikos,6,0,1,5,3,13,-10,1
Europa League - Group H 2016/17,Shakhtar Donetsk,6,6,0,0,21,5,16,18
Europa League - Group H 2016/17,AA Gent,6,2,2,2,9,13,-4,8
Europa League - Group H 2016/17,Braga,6,1,3,2,9,11,-2,6
Europa League - Group H 2016/17,Konyaspor,6,0,1,5,2,12,-10,1
Europa League - Group I 2016/17,Schalke,6,5,0,1,9,3,6,15
Europa League - Group I 2016/17,Krasnodar,6,2,1,3,8,8,0,7
Europa League - Group I 2016/17,Red Bull Salzburg,6,2,1,3,6,6,0,7
Europa League - Group I 2016/17,Nice,6,2,0,4,5,11,-6,6
Europa League - Group J 2016/17,Fiorentina,6,4,1,1,15,6,9,13
Europa League - Group J 2016/17,PAOK Salonika,6,3,1,2,7,6,1,10
Europa League - Group J 2016/17,Qarabag FK,6,2,1,3,7,12,-5,7
Europa League - Group J 2016/17,Slovan Liberec,6,1,1,4,7,12,-5,4
Europa League - Group K 2016/17,Sparta Prague,6,4,0,2,8,6,2,12
Europa League - Group K 2016/17,Hapoel Beer-Sheva,6,2,2,2,6,6,0,8
Europa League - Group K 2016/17,Southampton,6,2,2,2,6,4,2,8
Europa League - Group K 2016/17,Inter Milan,6,2,0,4,7,11,-4,6
Europa League - Group L 2016/17,Osmanlispor,6,3,1,2,10,7,3,10
Europa League - Group L 2016/17,Villarreal,6,2,3,1,9,8,1,9
Europa League - Group L 2016/17,FC Zurich,6,1,3,2,5,7,-2,6
Europa League - Group L 2016/17,FC Steaua Bucuresti,6,1,3,2,5,7,-2,6
Europa League - Group A 2017/18,Villarreal,6,3,2,1,10,6,4,11
Europa League - Group A 2017/18,Astana,6,3,1,2,10,7,3,10
Europa League - Group A 2017/18,Slavia Prague,6,2,2,2,6,6,0,8
Europa League - Group A 2017/18,Maccabi Tel Aviv,6,1,1,4,1,8,-7,4
Europa League - Group B 2017/18,Dynamo Kiev,6,4,1,1,15,9,6,13
Europa League - Group B 2017/18,Partizan Belgrade,6,2,2,2,8,9,-1,8
Europa League - Group B 2017/18,BSC Young Boys Bern,6,1,3,2,7,8,-1,6
Europa League - Group B 2017/18,Skenderbeu,6,1,2,3,6,10,-4,5
Europa League - Group C 2017/18,Braga,6,3,1,2,9,8,1,10
Europa League - Group C 2017/18,Ludogorets,6,2,3,1,7,5,2,9
Europa League - Group C 2017/18,Istanbul Buyuksehir,6,2,2,2,7,8,-1,8
Europa League - Group C 2017/18,Hoffenheim,6,1,2,3,8,10,-2,5
Europa League - Group D 2017/18,AC Milan,6,3,2,1,13,6,7,11
Europa League - Group D 2017/18,AEK Athens,6,1,5,0,6,5,1,8
Europa League - Group D 2017/18,Rijeka,6,2,1,3,11,12,-1,7
Europa League - Group D 2017/18,FK Austria Wien,6,1,2,3,9,16,-7,5
Europa League - Group E 2017/18,Atalanta,6,4,2,0,14,4,10,14
Europa League - Group E 2017/18,Lyon,6,3,2,1,11,4,7,11
Europa League - Group E 2017/18,Everton,6,1,1,4,7,15,-8,4
Europa League - Group E 2017/18,Apollon Limassol,6,0,3,3,5,14,-9,3
Europa League - Group F 2017/18,Lokomotiv Moscow,6,3,2,1,9,4,5,11
Europa League - Group F 2017/18,FC Copenhagen,6,2,3,1,7,3,4,9
Europa League - Group F 2017/18,Sheriff Tiraspol (Mol),6,2,3,1,4,4,0,9
Europa League - Group F 2017/18,Zlín,6,0,2,4,1,10,-9,2
Europa League - Group G 2017/18,FC Viktoria Plzen,6,4,0,2,13,8,5,12
Europa League - Group G 2017/18,FC Steaua Bucuresti,6,3,1,2,9,7,2,10
Europa League - Group G 2017/18,FC Lugano,6,3,0,3,9,11,-2,9
Europa League - Group G 2017/18,Hapoel Beer-Sheva,6,1,1,4,5,10,-5,4
Europa League - Group H 2017/18,Arsenal,6,4,1,1,14,4,10,13
Europa League - Group H 2017/18,Crvena Zvezda,6,2,3,1,3,2,1,9
Europa League - Group H 2017/18,Cologne,6,2,0,4,7,8,-1,6
Europa League - Group H 2017/18,BATE Borisov,6,1,2,3,6,16,-10,5
Europa League - Group I 2017/18,Red Bull Salzburg,6,3,3,0,7,1,6,12
Europa League - Group I 2017/18,Marseille,6,2,2,2,4,4,0,8
Europa League - Group I 2017/18,Konyaspor,6,1,3,2,4,6,-2,6
Europa League - Group I 2017/18,Vitoria de Guimaraes,6,1,2,3,5,9,-4,5
Europa League - Group J 2017/18,Athletic Bilbao,6,3,2,1,8,5,3,11
Europa League - Group J 2017/18,Ostersunds FK,6,3,2,1,8,4,4,11
Europa League - Group J 2017/18,FC Zorya Luhansk,6,2,0,4,3,9,-6,6
Europa League - Group J 2017/18,Hertha Berlin,6,1,2,3,6,7,-1,5
Europa League - Group K 2017/18,Lazio,6,4,1,1,12,7,5,13
Europa League - Group K 2017/18,Nice,6,3,0,3,12,7,5,9
Europa League - Group K 2017/18,Zulte-Waregem,6,2,1,3,8,13,-5,7
Europa League - Group K 2017/18,Vitesse Arnhem,6,1,2,3,5,10,-5,5
Europa League - Group L 2017/18,Zenit St. Petersburg,6,5,1,0,17,5,12,16
Europa League - Group L 2017/18,Real Sociedad,6,4,0,2,16,6,10,12
Europa League - Group L 2017/18,Rosenborg,6,1,2,3,6,11,-5,5
Europa League - Group L 2017/18,Vardar,6,0,1,5,3,20,-17,1
Europa League - Group A 2018/19,Bayer Leverkusen,6,4,1,1,16,9,7,13
Europa League - Group A 2018/19,FC Zurich,6,3,1,2,7,6,1,10
Europa League - Group A 2018/19,AEK Larnaca,6,1,2,3,6,12,-6,5
Europa League - Group A 2018/19,Ludogorets,6,0,4,2,5,7,-2,4
Europa League - Group B 2018/19,Red Bull Salzburg,6,6,0,0,17,6,11,18
Europa League - Group B 2018/19,Celtic,6,3,0,3,6,8,-2,9
Europa League - Group B 2018/19,RB Leipzig,6,2,1,3,9,8,1,7
Europa League - Group B 2018/19,Rosenborg,6,0,1,5,4,14,-10,1
Europa League - Group C 2018/19,Zenit St. Petersburg,6,3,2,1,6,5,1,11
Europa League - Group C 2018/19,Slavia Prague,6,3,1,2,4,3,1,10
Europa League - Group C 2018/19,Bordeaux,6,2,1,3,6,6,0,7
Europa League - Group C 2018/19,FC Copenhagen,6,1,2,3,3,5,-2,5
Europa League - Group D 2018/19,Dinamo Zagreb,6,4,2,0,11,3,8,14
Europa League - Group D 2018/19,Fenerbahce,6,2,2,2,7,7,0,8
Europa League - Group D 2018/19,FC Spartak Trnava,6,2,1,3,4,7,-3,7
Europa League - Group D 2018/19,Anderlecht,6,0,3,3,2,7,-5,3
Europa League - Group E 2018/19,Arsenal,6,5,1,0,12,2,10,16
Europa League - Group E 2018/19,Sporting Lisbon,6,4,1,1,13,3,10,13
Europa League - Group E 2018/19,Vorskla Poltava,6,1,0,5,4,13,-9,3
Europa League - Group E 2018/19,Qarabag FK,6,1,0,5,2,13,-11,3
Europa League - Group F 2018/19,Real Betis,6,3,3,0,7,2,5,12
Europa League - Group F 2018/19,Olympiakos FC,6,3,1,2,11,6,5,10
Europa League - Group F 2018/19,AC Milan,6,3,1,2,12,9,3,10
Europa League - Group F 2018/19,F91 Dudelange,6,0,1,5,3,16,-13,1
Europa League - Group G 2018/19,Villarreal,6,2,4,0,12,5,7,10
Europa League - Group G 2018/19,Rapid Wien,6,3,1,2,6,9,-3,10
Europa League - Group G 2018/19,Rangers,6,1,3,2,8,8,0,6
Europa League - Group G 2018/19,Spartak Moscow,6,1,2,3,8,12,-4,5
Europa League - Group H 2018/19,Eintracht Frankfurt,6,6,0,0,17,5,12,18
Europa League - Group H 2018/19,Lazio,6,3,0,3,9,11,-2,9
Europa League - Group H 2018/19,Apollon Limassol,6,2,1,3,10,10,0,7
Europa League - Group H 2018/19,Marseille,6,0,1,5,6,16,-10,1
Europa League - Group I 2018/19,Genk,6,3,2,1,14,8,6,11
Europa League - Group I 2018/19,Malmo FF,6,2,3,1,7,6,1,9
Europa League - Group I 2018/19,Besiktas,6,2,1,3,9,11,-2,7
Europa League - Group I 2018/19,Sarpsborg,6,1,2,3,8,13,-5,5
Europa League - Group J 2018/19,Sevilla,6,4,0,2,18,6,12,12
Europa League - Group J 2018/19,Krasnodar,6,4,0,2,8,8,0,12
Europa League - Group J 2018/19,Standard Liege,6,3,1,2,7,9,-2,10
Europa League - Group J 2018/19,Akhisar Belediye,6,0,1,5,4,14,-10,1
Europa League - Group K 2018/19,Dynamo Kiev,6,3,2,1,10,7,3,11
Europa League - Group K 2018/19,Rennes,6,3,0,3,7,8,-1,9
Europa League - Group K 2018/19,Astana,6,2,2,2,7,7,0,8
Europa League - Group K 2018/19,FK Jablonec,6,1,2,3,6,8,-2,5
Europa League - Group L 2018/19,Chelsea,6,5,1,0,12,3,9,16
Europa League - Group L 2018/19,BATE Borisov,6,3,0,3,9,9,0,9
Europa League - Group L 2018/19,MOL Vidi FC,6,2,1,3,5,7,-2,7
Europa League - Group L 2018/19,PAOK Salonika,6,1,0,5,5,12,-7,3
Europa League - Group A 2019/20,Sevilla,6,5,0,1,14,3,11,15
Europa League - Group A 2019/20,Apoel Nicosia,6,3,1,2,10,8,2,10
Europa League - Group A 2019/20,Qarabag FK,6,1,2,3,8,11,-3,5
Europa League - Group A 2019/20,F91 Dudelange,6,1,1,4,8,18,-10,4
Europa League - Group B 2019/20,Malmo FF,6,3,2,1,8,6,2,11
Europa League - Group B 2019/20,FC Copenhagen,6,2,3,1,5,4,1,9
Europa League - Group B 2019/20,Dynamo Kiev,6,1,4,1,7,7,0,7
Europa League - Group B 2019/20,FC Lugano,6,0,3,3,2,5,-3,3
Europa League - Group C 2019/20,Basel,6,4,1,1,12,4,8,13
Europa League - Group C 2019/20,Getafe,6,4,0,2,8,4,4,12
Europa League - Group C 2019/20,Krasnodar,6,3,0,3,7,11,-4,9
Europa League - Group C 2019/20,Trabzonspor,6,0,1,5,3,11,-8,1
Europa League - Group D 2019/20,Linz ASK,6,4,1,1,11,4,7,13
Europa League - Group D 2019/20,Sporting Lisbon,6,4,0,2,11,7,4,12
Europa League - Group D 2019/20,PSV Eindhoven,6,2,2,2,9,12,-3,8
Europa League - Group D 2019/20,Rosenborg,6,0,1,5,3,11,-8,1
Europa League - Group E 2019/20,Celtic,6,4,1,1,10,6,4,13
Europa League - Group E 2019/20,CFR Cluj-Napoca,6,4,0,2,6,4,2,12
Europa League - Group E 2019/20,Lazio,6,2,0,4,6,9,-3,6
Europa League - Group E 2019/20,Rennes,6,1,1,4,5,8,-3,4
Europa League - Group F 2019/20,Arsenal,6,3,2,1,14,7,7,11
Europa League - Group F 2019/20,Eintracht Frankfurt,6,3,0,3,8,10,-2,9
Europa League - Group F 2019/20,Standard Liege,6,2,2,2,8,10,-2,8
Europa League - Group F 2019/20,Vitoria de Guimaraes,6,1,2,3,7,10,-3,5
Europa League - Group G 2019/20,FC Porto,6,3,1,2,8,9,-1,10
Europa League - Group G 2019/20,Rangers,6,2,3,1,8,6,2,9
Europa League - Group G 2019/20,BSC Young Boys Bern,6,2,2,2,8,7,1,8
Europa League - Group G 2019/20,Feyenoord,6,1,2,3,7,9,-2,5
Europa League - Group H 2019/20,Espanyol,6,3,2,1,12,4,8,11
Europa League - Group H 2019/20,Ludogorets,6,2,2,2,10,10,0,8
Europa League - Group H 2019/20,Ferencvaros,6,1,4,1,5,7,-2,7
Europa League - Group H 2019/20,CSKA Moscow,6,1,2,3,3,9,-6,5
Europa League - Group I 2019/20,AA Gent,6,3,3,0,11,7,4,12
Europa League - Group I 2019/20,Wolfsburg,6,3,2,1,9,7,2,11
Europa League - Group I 2019/20,St Etienne,6,0,4,2,6,8,-2,4
Europa League - Group I 2019/20,FC Oleksandria,6,0,3,3,6,10,-4,3
Europa League - Group J 2019/20,Istanbul Buyuksehir,6,3,1,2,7,9,-2,10
Europa League - Group J 2019/20,Roma,6,2,3,1,12,6,6,9
Europa League - Group J 2019/20,M'gladbach,6,2,2,2,6,9,-3,8
Europa League - Group J 2019/20,RZ Pellets WAC,6,1,2,3,7,8,-1,5
Europa League - Group K 2019/20,Braga,6,4,2,0,15,9,6,14
Europa League - Group K 2019/20,Wolverhampton Wanderers,6,4,1,1,11,5,6,13
Europa League - Group K 2019/20,SK Slovan Bratislava,6,1,1,4,10,13,-3,4
Europa League - Group K 2019/20,Besiktas,6,1,0,5,6,15,-9,3
Europa League - Group L 2019/20,Manchester United,6,4,1,1,10,2,8,13
Europa League - Group L 2019/20,AZ Alkmaar,6,2,3,1,15,8,7,9
Europa League - Group L 2019/20,Partizan Belgrade,6,2,2,2,10,10,0,8
Europa League - Group L 2019/20,Astana,6,1,0,5,4,19,-15,3
Europa League - Group A 2020/21,CFR Cluj-Napoca,2,1,1,0,3,1,2,4
Europa League - Group A 2020/21,Roma,2,1,1,0,2,1,1,4
Europa League - Group A 2020/21,BSC Young Boys Bern,2,0,1,1,2,3,-1,1
Europa League - Group A 2020/21,CSKA Sofia,2,0,1,1,0,2,-2,1
Europa League - Group B 2020/21,Arsenal,2,2,0,0,5,1,4,6
Europa League - Group B 2020/21,Molde,2,2,0,0,3,1,2,6
Europa League - Group B 2020/21,Rapid Wien,2,0,0,2,1,3,-2,0
Europa League - Group B 2020/21,Dundalk,2,0,0,2,1,5,-4,0
Europa League - Group C 2020/21,Bayer Leverkusen,2,1,0,1,6,3,3,3
Europa League - Group C 2020/21,Hapoel Beer-Sheva,2,1,0,1,3,2,1,3
Europa League - Group C 2020/21,Slavia Prague,2,1,0,1,2,3,-1,3
Europa League - Group C 2020/21,Nice,2,1,0,1,3,6,-3,3
Europa League - Group D 2020/21,Benfica,2,2,0,0,7,2,5,6
Europa League - Group D 2020/21,Rangers,2,2,0,0,3,0,3,6
Europa League - Group D 2020/21,Lech Poznan,2,0,0,2,2,5,-3,0
Europa League - Group D 2020/21,Standard Liege,2,0,0,2,0,5,-5,0
Europa League - Group E 2020/21,Granada,2,1,1,0,2,1,1,4
Europa League - Group E 2020/21,PSV Eindhoven,2,1,0,1,3,3,0,3
Europa League - Group E 2020/21,PAOK Salonika,2,0,2,0,1,1,0,2
Europa League - Group E 2020/21,Omonia Nicosia,2,0,1,1,2,3,-1,1
Europa League - Group F 2020/21,AZ Alkmaar,2,2,0,0,5,1,4,6
Europa League - Group F 2020/21,Napoli,2,1,0,1,1,1,0,3
Europa League - Group F 2020/21,Real Sociedad,2,1,0,1,1,1,0,3
Europa League - Group F 2020/21,Rijeka,2,0,0,2,1,5,-4,0
Europa League - Group G 2020/21,Leicester City,2,2,0,0,5,1,4,6
Europa League - Group G 2020/21,Braga,2,2,0,0,5,1,4,6
Europa League - Group G 2020/21,FC Zorya Luhansk,2,0,0,2,1,5,-4,0
Europa League - Group G 2020/21,AEK Athens,2,0,0,2,1,5,-4,0
Europa League - Group H 2020/21,AC Milan,2,2,0,0,6,1,5,6
Europa League - Group H 2020/21,Lille,2,1,1,0,6,3,3,4
Europa League - Group H 2020/21,Celtic,2,0,1,1,3,5,-2,1
Europa League - Group H 2020/21,Sparta Prague,2,0,0,2,1,7,-6,0
Europa League - Group I 2020/21,Villarreal,2,2,0,0,8,4,4,6
Europa League - Group I 2020/21,Maccabi Tel Aviv,2,2,0,0,3,1,2,6
Europa League - Group I 2020/21,Sivasspor,2,0,0,2,4,7,-3,0
Europa League - Group I 2020/21,Qarabag FK,2,0,0,2,1,4,-3,0
Europa League - Group J 2020/21,Antwerp,2,2,0,0,3,1,2,6
Europa League - Group J 2020/21,Tottenham Hotspur,2,1,0,1,3,1,2,3
Europa League - Group J 2020/21,Linz ASK,2,1,0,1,4,6,-2,3
Europa League - Group J 2020/21,Ludogorets,2,0,0,2,4,6,-2,0
Europa League - Group K 2020/21,RZ Pellets WAC,2,1,1,0,5,2,3,4
Europa League - Group K 2020/21,CSKA Moscow,2,0,2,0,1,1,0,2
Europa League - Group K 2020/21,Dinamo Zagreb,2,0,2,0,0,0,0,2
Europa League - Group K 2020/21,Feyenoord,2,0,1,1,1,4,-3,1
Europa League - Group L 2020/21,Hoffenheim,2,2,0,0,6,1,5,6
Europa League - Group L 2020/21,Crvena Zvezda,2,1,0,1,5,3,2,3
Europa League - Group L 2020/21,Slovan Liberec,2,1,0,1,2,5,-3,3
Europa League - Group L 2020/21,AA Gent,2,0,0,2,1,5,-4,0
Blue Square North 2009/10,Southport,40,25,11,4,91,45,46,86
Blue Square North 2009/10,Fleetwood Town,40,26,7,7,86,44,42,85
Blue Square North 2009/10,Alfreton Town,40,21,11,8,77,45,32,74
Blue Square North 2009/10,Workington,40,20,10,10,46,37,9,70
Blue Square North 2009/10,Droylsden,40,18,10,12,82,62,20,64
Blue Square North 2009/10,Corby,40,18,9,13,73,62,11,63
Blue Square North 2009/10,Hinckley,40,16,14,10,60,52,8,62
Blue Square North 2009/10,Ilkeston Town,40,16,13,11,53,45,8,61
Blue Square North 2009/10,Stalybridge,40,16,7,17,71,64,7,55
Blue Square North 2009/10,Eastwood Town,40,15,9,16,50,55,-5,54
Blue Square North 2009/10,AFC Telford United,40,14,9,17,52,55,-3,51
Blue Square North 2009/10,Northwich Victoria *,40,15,13,12,62,55,7,48
Blue Square North 2009/10,Blyth Spartans,40,13,9,18,67,72,-5,48
Blue Square North 2009/10,Gainsborough Trinity,40,12,11,17,50,57,-7,47
Blue Square North 2009/10,Hyde,40,11,12,17,45,72,-27,45
Blue Square North 2009/10,Stafford Rangers,40,10,14,16,59,70,-11,44
Blue Square North 2009/10,Solihull Moors,40,11,9,20,47,58,-11,42
Blue Square North 2009/10,Gloucester,40,12,6,22,47,59,-12,42
Blue Square North 2009/10,Redditch United,40,10,8,22,49,83,-34,38
Blue Square North 2009/10,Vauxhall Motors,40,7,14,19,45,81,-36,35
Blue Square North 2009/10,Harrogate Town,40,8,6,26,41,80,-39,30
Blue Square North 2010/11,Alfreton Town,40,29,5,6,97,33,64,92
Blue Square North 2010/11,AFC Telford United,40,23,13,4,71,29,42,82
Blue Square North 2010/11,Boston United,40,23,10,7,72,33,39,79
Blue Square North 2010/11,Eastwood Town,40,22,7,11,82,50,32,73
Blue Square North 2010/11,Guiseley,40,20,13,7,56,41,15,73
Blue Square North 2010/11,Nuneaton,40,21,9,10,66,44,22,72
Blue Square North 2010/11,Solihull Moors,40,18,10,12,66,49,17,64
Blue Square North 2010/11,Droylsden,40,17,9,14,69,67,2,60
Blue Square North 2010/11,Blyth Spartans,40,16,10,14,61,54,7,58
Blue Square North 2010/11,Stalybridge,40,16,9,15,64,55,9,57
Blue Square North 2010/11,Workington,40,16,6,18,52,60,-8,54
Blue Square North 2010/11,Harrogate Town,40,13,11,16,53,66,-13,50
Blue Square North 2010/11,Corby,40,13,10,17,58,80,-22,49
Blue Square North 2010/11,Gloucester,40,14,5,21,49,63,-14,47
Blue Square North 2010/11,Hinckley,40,13,7,20,76,76,0,46
Blue Square North 2010/11,Worcester City,40,12,10,18,49,55,-6,46
Blue Square North 2010/11,Vauxhall Motors,40,12,9,19,52,71,-19,45
Blue Square North 2010/11,Gainsborough Trinity,40,12,5,23,50,74,-24,41
Blue Square North 2010/11,Hyde,40,10,6,24,44,73,-29,36
Blue Square North 2010/11,Stafford Rangers,40,8,8,24,39,78,-39,32
Blue Square North 2010/11,Redditch United *,40,2,8,30,30,105,-75,9
Blue Square North 2011/12,Hyde,42,27,9,6,90,36,54,90
Blue Square North 2011/12,Guiseley,42,25,10,7,87,50,37,85
Blue Square North 2011/12,FC Halifax,42,21,11,10,80,59,21,74
Blue Square North 2011/12,Gainsborough Trinity,42,23,5,14,74,61,13,74
Blue Square North 2011/12,Nuneaton *,42,22,12,8,74,41,33,72
Blue Square North 2011/12,Stalybridge,42,20,11,11,83,64,19,71
Blue Square North 2011/12,Worcester City,42,18,11,13,63,58,5,65
Blue Square North 2011/12,Altrincham,42,17,10,15,90,71,19,61
Blue Square North 2011/12,Droylsden,42,16,11,15,83,86,-3,59
Blue Square North 2011/12,Bishops Stortford,42,17,7,18,70,75,-5,58
Blue Square North 2011/12,Boston United,42,15,9,18,60,67,-7,54
Blue Square North 2011/12,Colwyn Bay,42,15,8,19,55,70,-15,53
Blue Square North 2011/12,Workington,42,14,10,18,56,61,-5,52
Blue Square North 2011/12,Gloucester,42,15,7,20,53,60,-7,52
Blue Square North 2011/12,Harrogate Town,42,14,10,18,59,69,-10,52
Blue Square North 2011/12,Histon,42,12,15,15,67,72,-5,51
Blue Square North 2011/12,Corby,42,14,8,20,65,71,-6,50
Blue Square North 2011/12,Vauxhall Motors,42,14,8,20,63,78,-15,50
Blue Square North 2011/12,Solihull Moors,42,13,10,19,44,54,-10,49
Blue Square North 2011/12,Hinckley,42,13,9,20,75,90,-15,48
Blue Square North 2011/12,Blyth Spartans,42,7,13,22,51,81,-30,34
Blue Square North 2011/12,Eastwood Town,42,4,8,30,37,105,-68,20
Skrill North 2012/13,Chester FC,42,34,5,3,103,32,71,107
Skrill North 2012/13,Guiseley,42,28,7,7,83,45,38,91
Skrill North 2012/13,Brackley Town,42,26,7,9,76,44,32,85
Skrill North 2012/13,Altrincham,42,24,8,10,100,51,49,80
Skrill North 2012/13,FC Halifax,42,21,12,9,86,38,48,75
Skrill North 2012/13,Harrogate Town,42,20,9,13,72,50,22,69
Skrill North 2012/13,Bradford P A,42,19,9,14,75,52,23,66
Skrill North 2012/13,Gainsborough Trinity,42,18,12,12,68,45,23,66
Skrill North 2012/13,Solihull Moors *,42,17,9,16,58,54,4,56
Skrill North 2012/13,Oxford City,42,13,16,13,62,57,5,55
Skrill North 2012/13,Gloucester,42,16,6,20,54,63,-9,54
Skrill North 2012/13,Vauxhall Motors,42,15,8,19,58,64,-6,53
Skrill North 2012/13,Stalybridge,42,13,13,16,55,62,-7,52
Skrill North 2012/13,Workington *,42,16,8,18,60,68,-8,52
Skrill North 2012/13,Worcester City,42,14,8,20,57,62,-5,50
Skrill North 2012/13,Boston United,42,14,7,21,68,73,-5,49
Skrill North 2012/13,Bishops Stortford,42,12,13,17,58,74,-16,49
Skrill North 2012/13,Colwyn Bay,42,14,7,21,57,78,-21,49
Skrill North 2012/13,Histon,42,11,11,20,48,73,-25,44
Skrill North 2012/13,Corby,42,12,8,22,66,92,-26,44
Skrill North 2012/13,Droylsden,42,5,7,30,43,124,-81,22
Skrill North 2012/13,Hinckley *,42,3,4,35,37,143,-106,7
Conference North 2013/14,AFC Telford United,42,25,10,7,82,53,29,85
Conference North 2013/14,North Ferriby Utd,42,24,10,8,80,51,29,82
Conference North 2013/14,Altrincham,42,24,9,9,95,51,44,81
Conference North 2013/14,Hednesford,42,24,6,12,87,65,22,78
Conference North 2013/14,Guiseley,42,23,9,10,78,56,22,78
Conference North 2013/14,Boston United,42,20,12,10,85,60,25,72
Conference North 2013/14,Brackley Town,42,17,16,9,66,45,21,67
Conference North 2013/14,Solihull Moors,42,17,14,11,63,52,11,65
Conference North 2013/14,Harrogate Town *,42,19,9,14,75,59,16,63
Conference North 2013/14,Bradford P A,42,15,12,15,66,70,-4,57
Conference North 2013/14,Barrow,42,14,14,14,50,56,-6,56
Conference North 2013/14,Colwyn Bay,42,14,13,15,63,67,-4,55
Conference North 2013/14,Leamington,42,13,13,16,54,53,1,52
Conference North 2013/14,Stockport County,42,12,14,16,58,57,1,50
Conference North 2013/14,Worcester City,42,13,11,18,40,53,-13,50
Conference North 2013/14,Gainsborough Trinity,42,13,6,23,67,86,-19,45
Conference North 2013/14,Gloucester,42,11,11,20,64,77,-13,44
Conference North 2013/14,Vauxhall Motors,42,12,8,22,43,74,-31,44
Conference North 2013/14,Stalybridge,42,10,9,23,57,88,-31,39
Conference North 2013/14,Oxford City *,42,9,13,20,50,70,-20,37
Conference North 2013/14,Histon,42,7,11,24,42,76,-34,32
Conference North 2013/14,Workington,42,6,10,26,39,85,-46,28
Conference North 2014/15,Barrow,42,26,9,7,81,43,38,87
Conference North 2014/15,AFC Fylde,42,25,10,7,93,43,50,85
Conference North 2014/15,Boston United,42,20,12,10,75,51,24,72
Conference North 2014/15,Chorley,42,20,11,11,76,55,21,71
Conference North 2014/15,Guiseley,42,20,10,12,68,49,19,70
Conference North 2014/15,Oxford City,42,20,9,13,80,66,14,69
Conference North 2014/15,Tamworth,42,19,12,11,66,57,9,69
Conference North 2014/15,Hednesford,42,17,10,15,63,49,14,61
Conference North 2014/15,Worcester City,42,16,12,14,54,54,0,60
Conference North 2014/15,North Ferriby Utd,42,14,16,12,64,63,1,58
Conference North 2014/15,Stockport County,42,16,9,17,56,59,-3,57
Conference North 2014/15,Solihull Moors,42,16,7,19,68,63,5,55
Conference North 2014/15,Bradford P A,42,14,11,17,52,66,-14,53
Conference North 2014/15,Gloucester,42,14,10,18,63,75,-12,52
Conference North 2014/15,Harrogate Town,42,14,10,18,49,61,-12,52
Conference North 2014/15,Lowestoft Town,42,12,15,15,54,66,-12,51
Conference North 2014/15,Gainsborough Trinity,42,14,8,20,59,67,-8,50
Conference North 2014/15,Brackley Town,42,13,8,21,39,62,-23,47
Conference North 2014/15,Stalybridge,42,12,9,21,54,70,-16,45
Conference North 2014/15,Colwyn Bay,42,11,12,19,59,82,-23,45
Conference North 2014/15,Leamington,42,10,10,22,59,74,-15,40
Conference North 2014/15,Hyde,42,3,12,27,49,106,-57,21
Vanarama National League North 2015/16,Solihull Moors,42,25,10,7,84,48,36,85
Vanarama National League North 2015/16,North Ferriby Utd,42,22,10,10,82,49,33,76
Vanarama National League North 2015/16,AFC Fylde,42,22,9,11,76,53,23,75
Vanarama National League North 2015/16,Harrogate Town,42,21,9,12,73,46,27,72
Vanarama National League North 2015/16,Boston United,42,22,5,15,73,60,13,71
Vanarama National League North 2015/16,Nuneaton *,42,20,13,9,71,46,25,70
Vanarama National League North 2015/16,Tamworth,42,16,15,11,55,45,10,63
Vanarama National League North 2015/16,Chorley,42,18,9,15,64,55,9,63
Vanarama National League North 2015/16,Stockport County,42,15,14,13,50,49,1,59
Vanarama National League North 2015/16,Alfreton Town,42,15,13,14,58,54,4,58
Vanarama National League North 2015/16,Curzon Ashton,42,14,15,13,55,52,3,57
Vanarama National League North 2015/16,Stalybridge,42,14,11,17,62,75,-13,53
Vanarama National League North 2015/16,FC United of Manchester,42,15,8,19,60,75,-15,53
Vanarama National League North 2015/16,Bradford P A,42,13,11,18,51,59,-8,50
Vanarama National League North 2015/16,Gloucester,42,12,14,16,39,49,-10,50
Vanarama National League North 2015/16,Gainsborough Trinity,42,14,8,20,46,62,-16,50
Vanarama National League North 2015/16,Worcester City,42,12,12,18,55,61,-6,48
Vanarama National League North 2015/16,AFC Telford United,42,13,8,21,47,60,-13,47
Vanarama National League North 2015/16,Brackley Town,42,11,13,18,45,54,-9,46
Vanarama National League North 2015/16,Lowestoft Town,42,12,10,20,48,69,-21,46
Vanarama National League North 2015/16,Hednesford,42,8,14,20,50,77,-27,38
Vanarama National League North 2015/16,Corby,42,7,11,24,47,93,-46,32
National League North 2016/17,AFC Fylde,42,26,10,6,109,60,49,88
National League North 2016/17,Kidderminster Harriers,42,25,7,10,76,41,35,82
National League North 2016/17,FC Halifax,42,24,8,10,81,43,38,80
National League North 2016/17,Salford City,42,22,11,9,79,44,35,77
National League North 2016/17,Darlington,42,22,10,10,89,67,22,76
National League North 2016/17,Chorley,42,20,14,8,60,41,19,74
National League North 2016/17,Brackley Town,42,20,13,9,66,43,23,73
National League North 2016/17,Stockport County,42,19,16,7,59,41,18,73
National League North 2016/17,Tamworth,42,21,6,15,73,67,6,69
National League North 2016/17,Gloucester,42,18,10,14,69,61,8,64
National League North 2016/17,Harrogate Town,42,16,11,15,71,63,8,59
National League North 2016/17,Nuneaton,42,14,13,15,67,69,-2,55
National League North 2016/17,FC United of Manchester,42,14,12,16,69,68,1,54
National League North 2016/17,Curzon Ashton,42,14,10,18,63,72,-9,52
National League North 2016/17,Boston United,42,12,11,19,54,72,-18,47
National League North 2016/17,Bradford P A,42,12,7,23,46,74,-28,43
National League North 2016/17,AFC Telford United,42,10,12,20,38,57,-19,42
National League North 2016/17,Alfreton Town,42,11,9,22,62,95,-33,42
National League North 2016/17,Gainsborough Trinity,42,8,12,22,51,84,-33,36
National League North 2016/17,Worcester City,42,7,14,21,44,63,-19,35
National League North 2016/17,Stalybridge,42,8,5,29,40,89,-49,29
National League North 2016/17,Altrincham,42,4,9,29,39,91,-52,21
National League North 2017/18,Salford City,42,28,7,7,80,45,35,91
National League North 2017/18,Harrogate Town,42,26,7,9,100,49,51,85
National League North 2017/18,Brackley Town,42,23,11,8,72,37,35,80
National League North 2017/18,Kidderminster Harriers,42,20,12,10,76,50,26,72
National League North 2017/18,Stockport County,42,20,9,13,75,57,18,69
National League North 2017/18,Chorley,42,18,14,10,52,39,13,68
National League North 2017/18,Bradford P A,42,18,9,15,66,56,10,63
National League North 2017/18,Spennymoor Town,42,18,9,15,71,67,4,63
National League North 2017/18,Boston United,42,17,9,16,67,66,1,60
National League North 2017/18,Blyth Spartans,42,19,2,21,76,69,7,59
National League North 2017/18,York City,42,16,10,16,65,62,3,58
National League North 2017/18,Darlington,42,14,13,15,58,58,0,55
National League North 2017/18,Nuneaton,42,14,13,15,50,57,-7,55
National League North 2017/18,AFC Telford United,42,16,5,21,55,69,-14,53
National League North 2017/18,Southport,42,14,8,20,60,72,-12,50
National League North 2017/18,FC United of Manchester,42,14,8,20,58,72,-14,50
National League North 2017/18,Alfreton Town,42,14,7,21,67,71,-4,49
National League North 2017/18,Curzon Ashton,42,12,13,17,52,66,-14,49
National League North 2017/18,Leamington,42,13,10,19,51,65,-14,49
National League North 2017/18,Gainsborough Trinity,42,14,4,24,47,73,-26,46
National League North 2017/18,Tamworth,42,11,9,22,55,77,-22,42
National League North 2017/18,North Ferriby Utd,42,4,9,29,25,101,-76,21
National League North 2018/19,Stockport County,42,24,10,8,77,36,41,82
National League North 2018/19,Chorley,42,24,9,9,83,41,42,81
National League North 2018/19,Brackley Town,42,22,11,9,72,40,32,77
National League North 2018/19,Spennymoor Town,42,22,10,10,78,48,30,76
National League North 2018/19,Altrincham,42,20,11,11,85,56,29,71
National League North 2018/19,Blyth Spartans,42,20,9,13,74,62,12,69
National League North 2018/19,Bradford P A,42,18,11,13,71,61,10,65
National League North 2018/19,AFC Telford United,42,17,14,11,64,55,9,65
National League North 2018/19,Chester FC,42,16,14,12,60,62,-2,62
National League North 2018/19,Kidderminster Harriers,42,17,9,16,68,62,6,60
National League North 2018/19,Boston United,42,17,7,18,62,60,2,58
National League North 2018/19,York City,42,16,10,16,58,63,-5,58
National League North 2018/19,Leamington,42,13,15,14,57,60,-3,54
National League North 2018/19,Southport,42,13,14,15,58,55,3,53
National League North 2018/19,Alfreton Town,42,13,12,17,53,67,-14,51
National League North 2018/19,Darlington,42,12,14,16,56,62,-6,50
National League North 2018/19,Hereford FC,42,11,16,15,47,58,-11,49
National League North 2018/19,Curzon Ashton,42,13,10,19,44,71,-27,49
National League North 2018/19,Guiseley,42,9,17,16,46,60,-14,44
National League North 2018/19,Ashton Utd,42,9,8,25,43,86,-43,35
National League North 2018/19,FC United of Manchester,42,8,10,24,49,82,-33,34
National League North 2018/19,Nuneaton,42,4,7,31,38,96,-58,19
National League North 2019/20,York City,34,19,9,6,52,28,24,66
National League North 2019/20,Kings Lynn Town,32,19,7,6,63,39,24,64
National League North 2019/20,Brackley Town,34,16,12,6,61,25,36,60
National League North 2019/20,Boston United,32,17,7,8,46,32,14,58
National League North 2019/20,Altrincham,33,16,9,8,62,40,22,57
National League North 2019/20,Spennymoor Town,34,15,10,9,63,45,18,55
National League North 2019/20,Chester FC,32,15,9,8,58,38,20,54
National League North 2019/20,Gateshead,31,14,10,7,47,31,16,52
National League North 2019/20,Guiseley,33,14,8,11,52,41,11,50
National League North 2019/20,Farsley,34,14,6,14,50,45,5,48
National League North 2019/20,Darlington,33,14,6,13,43,50,-7,48
National League North 2019/20,Southport,32,12,7,13,40,41,-1,43
National League North 2019/20,AFC Telford United,34,11,9,14,51,56,-5,42
National League North 2019/20,Alfreton Town,32,12,4,16,48,55,-7,40
National League North 2019/20,Hereford FC,35,9,12,14,39,56,-17,39
National League North 2019/20,Kidderminster Harriers,33,10,8,15,39,43,-4,38
National League North 2019/20,Leamington,32,9,8,15,39,51,-12,35
National League North 2019/20,Curzon Ashton,33,8,10,15,34,42,-8,34
National League North 2019/20,Gloucester,30,9,6,15,39,57,-18,33
National League North 2019/20,Kettering Town,31,7,11,13,36,46,-10,32
National League North 2019/20,Blyth Spartans,33,6,5,22,32,78,-46,23
National League North 2019/20,Bradford P A,33,5,5,23,25,80,-55,20
National League North 2020/21,Gloucester,4,4,0,0,13,4,9,12
National League North 2020/21,AFC Fylde,4,4,0,0,7,2,5,12
National League North 2020/21,Boston United,4,3,1,0,9,3,6,10
National League North 2020/21,Kidderminster Harriers,4,3,0,1,8,3,5,9
National League North 2020/21,Chester FC,5,3,0,2,9,8,1,9
National League North 2020/21,Southport,4,2,1,1,4,1,3,7
National League North 2020/21,AFC Telford United,5,2,1,2,7,5,2,7
National League North 2020/21,Spennymoor Town,3,2,1,0,5,3,2,7
National League North 2020/21,York City,3,1,2,0,4,2,2,5
National League North 2020/21,Alfreton Town,3,1,2,0,3,2,1,5
National League North 2020/21,Curzon Ashton,5,1,2,2,6,9,-3,5
National League North 2020/21,Guiseley,3,1,1,1,5,2,3,4
National League North 2020/21,Bradford P A,4,1,1,2,4,5,-1,4
National League North 2020/21,Hereford FC,3,1,1,1,1,2,-1,4
National League North 2020/21,Darlington,3,1,0,2,4,4,0,3
National League North 2020/21,Kettering Town,3,1,0,2,6,7,-1,3
National League North 2020/21,Gateshead,3,1,0,2,2,3,-1,3
National League North 2020/21,Brackley Town,3,0,2,1,2,5,-3,2
National League North 2020/21,Farsley,4,0,1,3,3,7,-4,1
National League North 2020/21,Chorley,5,0,1,4,2,8,-6,1
National League North 2020/21,Blyth Spartans,5,0,1,4,2,16,-14,1
National League North 2020/21,Leamington,2,0,0,2,2,7,-5,0
Blue Square South 2009/10,Newport County AFC,42,32,7,3,93,26,67,103
Blue Square South 2009/10,Dover,42,22,9,11,66,47,19,75
Blue Square South 2009/10,Chelmsford,42,22,9,11,62,48,14,75
Blue Square South 2009/10,Bath City,42,20,12,10,66,46,20,72
Blue Square South 2009/10,Woking,42,21,9,12,57,44,13,72
Blue Square South 2009/10,Havant and Waterlooville,42,19,14,9,65,44,21,71
Blue Square South 2009/10,Braintree Town,42,18,17,7,56,41,15,71
Blue Square South 2009/10,Staines Town,42,18,13,11,59,40,19,67
Blue Square South 2009/10,Welling United,42,18,9,15,66,51,15,63
Blue Square South 2009/10,Thurrock,42,16,13,13,66,60,6,61
Blue Square South 2009/10,Eastleigh,42,17,9,16,71,66,5,60
Blue Square South 2009/10,Bromley,42,15,10,17,68,64,4,55
Blue Square South 2009/10,St Albans,42,15,10,17,45,55,-10,55
Blue Square South 2009/10,Hampton & Richmond,42,14,9,19,56,66,-10,51
Blue Square South 2009/10,Basingstoke Town,42,13,10,19,49,68,-19,49
Blue Square South 2009/10,Maidenhead United,42,12,12,18,52,59,-7,48
Blue Square South 2009/10,Dorchester,42,13,9,20,56,74,-18,48
Blue Square South 2009/10,Bishops Stortford,42,12,11,19,48,59,-11,47
Blue Square South 2009/10,Lewes,42,9,15,18,49,63,-14,42
Blue Square South 2009/10,Worcester City,42,10,10,22,48,60,-12,40
Blue Square South 2009/10,Weston-s-Mare,42,5,8,29,48,93,-45,23
Blue Square South 2009/10,Weymouth,42,5,7,30,31,103,-72,22
Blue Square South 2010/11,Braintree Town,42,27,8,7,78,33,45,89
Blue Square South 2010/11,Farnborough,42,25,7,10,83,47,36,82
Blue Square South 2010/11,Ebbsfleet United,42,22,12,8,75,51,24,78
Blue Square South 2010/11,Chelmsford,42,23,8,11,82,50,32,77
Blue Square South 2010/11,Woking,42,22,10,10,62,42,20,76
Blue Square South 2010/11,Welling United *,42,24,8,10,81,47,34,75
Blue Square South 2010/11,Dover,42,22,8,12,80,51,29,74
Blue Square South 2010/11,Eastleigh,42,22,6,14,74,53,21,72
Blue Square South 2010/11,Havant and Waterlooville,42,16,10,16,56,51,5,58
Blue Square South 2010/11,Dartford,42,15,12,15,60,60,0,57
Blue Square South 2010/11,Bromley,42,15,12,15,49,61,-12,57
Blue Square South 2010/11,Weston-s-Mare,42,15,8,19,56,67,-11,53
Blue Square South 2010/11,Basingstoke Town,42,13,10,19,50,63,-13,49
Blue Square South 2010/11,Boreham Wood,42,12,11,19,56,67,-11,47
Blue Square South 2010/11,Staines Town,42,11,14,17,48,63,-15,47
Blue Square South 2010/11,Bishops Stortford,42,13,6,23,48,79,-31,45
Blue Square South 2010/11,Dorchester,42,10,14,18,49,59,-10,44
Blue Square South 2010/11,Hampton & Richmond,42,9,15,18,43,60,-17,42
Blue Square South 2010/11,Maidenhead United,42,10,10,22,43,70,-27,40
Blue Square South 2010/11,Thurrock,42,8,13,21,50,77,-27,37
Blue Square South 2010/11,Lewes,42,9,9,24,34,70,-36,36
Blue Square South 2010/11,St Albans *,42,7,13,22,39,75,-36,24
Blue Square South 2011/12,Woking,42,30,7,5,92,41,51,97
Blue Square South 2011/12,Dartford,42,26,10,6,89,40,49,88
Blue Square South 2011/12,Welling United,42,24,9,9,79,47,32,81
Blue Square South 2011/12,Sutton United,42,20,14,8,68,53,15,74
Blue Square South 2011/12,Basingstoke Town,42,20,11,11,65,50,15,71
Blue Square South 2011/12,Chelmsford,42,18,13,11,67,44,23,67
Blue Square South 2011/12,Dover,42,17,15,10,62,49,13,66
Blue Square South 2011/12,Boreham Wood,42,17,10,15,66,58,8,61
Blue Square South 2011/12,Tonbridge Angels,42,15,12,15,70,67,3,57
Blue Square South 2011/12,Salisbury City,42,15,12,15,55,54,1,57
Blue Square South 2011/12,Dorchester,42,16,8,18,58,65,-7,56
Blue Square South 2011/12,Eastleigh,42,15,9,18,57,63,-6,54
Blue Square South 2011/12,Weston-s-Mare,42,14,9,19,58,71,-13,51
Blue Square South 2011/12,Truro City,42,13,9,20,65,80,-15,48
Blue Square South 2011/12,Staines Town,42,12,10,20,53,63,-10,46
Blue Square South 2011/12,Farnborough *,42,15,6,21,52,79,-27,46
Blue Square South 2011/12,Bromley,42,10,15,17,52,66,-14,45
Blue Square South 2011/12,Eastbourne Borough,42,12,9,21,54,69,-15,45
Blue Square South 2011/12,Havant and Waterlooville,42,11,11,20,64,75,-11,44
Blue Square South 2011/12,Maidenhead United,42,11,10,21,49,74,-25,43
Blue Square South 2011/12,Hampton & Richmond,42,10,12,20,53,69,-16,42
Blue Square South 2011/12,Thurrock,42,5,11,26,33,84,-51,26
Skrill South 2012/13,Welling United,42,26,8,8,90,44,46,86
Skrill South 2012/13,Salisbury City *,42,25,8,9,80,47,33,82
Skrill South 2012/13,Dover,42,22,10,10,69,44,25,76
Skrill South 2012/13,Eastleigh,42,22,6,14,79,61,18,72
Skrill South 2012/13,Chelmsford,42,22,6,14,70,56,14,72
Skrill South 2012/13,Sutton United,42,20,10,12,66,49,17,70
Skrill South 2012/13,Weston-s-Mare,42,19,10,13,61,55,6,67
Skrill South 2012/13,Dorchester,42,19,8,15,59,62,-3,65
Skrill South 2012/13,Boreham Wood,42,15,17,10,59,46,13,62
Skrill South 2012/13,Havant and Waterlooville,42,14,16,12,68,60,8,58
Skrill South 2012/13,Bath City,42,15,10,17,60,58,2,55
Skrill South 2012/13,Eastbourne Borough,42,14,9,19,42,52,-10,51
Skrill South 2012/13,Farnborough *,42,19,7,16,76,75,1,50
Skrill South 2012/13,Basingstoke Town,42,12,12,18,63,73,-10,48
Skrill South 2012/13,Bromley,42,14,6,22,54,69,-15,48
Skrill South 2012/13,Tonbridge Angels,42,12,12,18,56,77,-21,48
Skrill South 2012/13,Hayes & Yeading,42,13,9,20,64,89,-25,48
Skrill South 2012/13,Staines Town,42,13,8,21,61,78,-17,47
Skrill South 2012/13,Maidenhead United,42,13,6,23,64,68,-4,45
Skrill South 2012/13,Hornchurch,42,11,11,20,47,64,-17,44
Skrill South 2012/13,Billericay Town,42,11,7,24,62,90,-28,40
Skrill South 2012/13,Truro City *,42,9,8,25,57,90,-33,25
Conference South 2013/14,Eastleigh,42,26,8,8,71,40,31,86
Conference South 2013/14,Sutton United,42,23,12,7,77,39,38,81
Conference South 2013/14,Bromley,42,25,5,12,82,50,32,80
Conference South 2013/14,Ebbsfleet United,42,21,11,10,67,40,27,74
Conference South 2013/14,Dover,42,20,9,13,63,38,25,69
Conference South 2013/14,Havant and Waterlooville,42,19,12,11,57,43,14,69
Conference South 2013/14,Bath City,42,18,12,12,64,52,12,66
Conference South 2013/14,Staines Town,42,18,9,15,56,57,-1,63
Conference South 2013/14,Concord Rangers,42,17,10,15,58,59,-1,61
Conference South 2013/14,Eastbourne Borough,42,16,10,16,55,59,-4,58
Conference South 2013/14,Weston-s-Mare,42,16,9,17,50,55,-5,57
Conference South 2013/14,Gosport Borough,42,16,7,19,46,51,-5,55
Conference South 2013/14,Boreham Wood,42,14,11,17,65,55,10,53
Conference South 2013/14,Basingstoke Town,42,15,8,19,55,56,-1,53
Conference South 2013/14,Bishops Stortford,42,13,13,16,63,68,-5,52
Conference South 2013/14,Farnborough,42,15,5,22,62,78,-16,50
Conference South 2013/14,Chelmsford,42,14,7,21,57,77,-20,49
Conference South 2013/14,Maidenhead United,42,12,10,20,55,69,-14,46
Conference South 2013/14,Whitehawk,42,12,10,20,56,71,-15,46
Conference South 2013/14,Hayes & Yeading,42,13,6,23,45,52,-7,45
Conference South 2013/14,Tonbridge Angels,42,9,13,20,43,77,-34,40
Conference South 2013/14,Dorchester,42,8,7,27,33,94,-61,31
Conference South 2014/15,Bromley,40,23,8,9,79,46,33,77
Conference South 2014/15,Boreham Wood,40,23,6,11,79,44,35,75
Conference South 2014/15,Basingstoke Town,40,22,7,11,67,43,24,73
Conference South 2014/15,Whitehawk,40,22,6,12,62,47,15,72
Conference South 2014/15,Havant and Waterlooville,40,21,7,12,61,41,20,70
Conference South 2014/15,Gosport Borough,40,19,10,11,63,40,23,67
Conference South 2014/15,Concord Rangers,40,18,11,11,60,45,15,65
Conference South 2014/15,Ebbsfleet United,40,17,9,14,60,41,19,60
Conference South 2014/15,Hemel Hempstead,40,16,12,12,64,60,4,60
Conference South 2014/15,Chelmsford,40,17,5,18,65,71,-6,56
Conference South 2014/15,Eastbourne Borough,40,14,13,13,51,50,1,55
Conference South 2014/15,Wealdstone,40,14,12,14,56,56,0,54
Conference South 2014/15,St Albans,40,16,6,18,53,53,0,54
Conference South 2014/15,Bath City,40,15,8,17,59,57,2,53
Conference South 2014/15,Sutton United,40,13,11,16,50,54,-4,50
Conference South 2014/15,Bishops Stortford,40,12,10,18,55,69,-14,46
Conference South 2014/15,Weston-s-Mare,40,13,5,22,55,86,-31,44
Conference South 2014/15,Maidenhead United,40,10,13,17,54,70,-16,43
Conference South 2014/15,Hayes & Yeading,40,11,9,20,39,58,-19,42
Conference South 2014/15,Farnborough,40,8,6,26,42,101,-59,30
Conference South 2014/15,Staines Town,40,7,4,29,39,82,-43,25
Vanarama National League South 2015/16,Sutton United,42,26,12,4,83,32,51,90
Vanarama National League South 2015/16,Ebbsfleet United,42,24,12,6,73,36,37,84
Vanarama National League South 2015/16,Maidstone Utd,42,24,5,13,55,40,15,77
Vanarama National League South 2015/16,Truro City,42,17,14,11,62,55,7,65
Vanarama National League South 2015/16,Whitehawk,42,18,10,14,75,62,13,64
Vanarama National League South 2015/16,Hemel Hempstead,42,16,13,13,72,66,6,61
Vanarama National League South 2015/16,Maidenhead United,42,16,11,15,66,62,4,59
Vanarama National League South 2015/16,Dartford,42,16,11,15,58,56,2,59
Vanarama National League South 2015/16,Gosport Borough,42,15,11,16,53,63,-10,56
Vanarama National League South 2015/16,Concord Rangers,42,15,10,17,66,68,-2,55
Vanarama National League South 2015/16,Bishops Stortford,42,15,10,17,56,63,-7,55
Vanarama National League South 2015/16,Oxford City,42,13,15,14,70,60,10,54
Vanarama National League South 2015/16,Wealdstone,42,12,17,13,63,64,-1,53
Vanarama National League South 2015/16,Bath City,42,14,11,17,50,61,-11,53
Vanarama National League South 2015/16,Chelmsford,42,15,7,20,66,64,2,52
Vanarama National League South 2015/16,Weston-s-Mare,42,14,9,19,63,76,-13,51
Vanarama National League South 2015/16,Eastbourne Borough,42,13,11,18,60,63,-3,50
Vanarama National League South 2015/16,St Albans,42,13,10,19,58,65,-7,49
Vanarama National League South 2015/16,Margate,42,13,8,21,51,73,-22,47
Vanarama National League South 2015/16,Havant and Waterlooville,42,12,11,19,52,75,-23,47
Vanarama National League South 2015/16,Hayes & Yeading,42,11,13,18,51,76,-25,46
Vanarama National League South 2015/16,Basingstoke Town,42,9,11,22,46,69,-23,38
National League South - Play-Offs 2016/17,Maidenhead United,42,30,8,4,93,29,64,98
National League South - Play-Offs 2016/17,Ebbsfleet United,42,29,9,4,96,30,66,96
National League South - Play-Offs 2016/17,Dartford,42,25,9,8,83,45,38,84
National League South - Play-Offs 2016/17,Chelmsford,42,23,13,6,89,47,42,82
National League South - Play-Offs 2016/17,Poole Town,42,20,11,11,63,49,14,71
National League South - Play-Offs 2016/17,Hungerford Town,42,19,13,10,67,49,18,70
National League South - Play-Offs 2016/17,Hampton & Richmond,42,19,12,11,81,56,25,69
National League South - Play-Offs 2016/17,Wealdstone,42,18,12,12,62,58,4,66
National League South - Play-Offs 2016/17,Bath City,42,18,8,16,71,52,19,62
National League South - Play-Offs 2016/17,St Albans,42,16,11,15,72,66,6,59
National League South - Play-Offs 2016/17,Eastbourne Borough,42,16,10,16,82,70,12,58
National League South - Play-Offs 2016/17,Hemel Hempstead,42,15,12,15,74,83,-9,57
National League South - Play-Offs 2016/17,East Thurrock United,42,14,14,14,73,65,8,56
National League South - Play-Offs 2016/17,Oxford City,42,15,7,20,48,73,-25,52
National League South - Play-Offs 2016/17,Weston-s-Mare,42,14,6,22,63,69,-6,48
National League South - Play-Offs 2016/17,Welling United,42,12,7,23,64,69,-5,43
National League South - Play-Offs 2016/17,Whitehawk,42,12,7,23,51,72,-21,43
National League South - Play-Offs 2016/17,Concord Rangers,42,10,12,20,57,75,-18,42
National League South - Play-Offs 2016/17,Truro City,42,11,7,24,53,99,-46,40
National League South - Play-Offs 2016/17,Gosport Borough,42,9,9,24,45,101,-56,36
National League South - Play-Offs 2016/17,Bishops Stortford,42,8,3,31,29,104,-75,27
National League South - Play-Offs 2016/17,Margate,42,7,4,31,26,81,-55,25
National League South 2017/18,Havant and Waterlooville,42,25,11,6,70,30,40,86
National League South 2017/18,Dartford,42,26,8,8,81,44,37,86
National League South 2017/18,Chelmsford,42,21,11,10,68,45,23,74
National League South 2017/18,Hampton & Richmond,42,18,18,6,58,37,21,72
National League South 2017/18,Hemel Hempstead,42,19,13,10,71,51,20,70
National League South 2017/18,Braintree Town,42,19,13,10,73,55,18,69
National League South 2017/18,Truro City,42,20,9,13,71,55,16,69
National League South 2017/18,St Albans,42,19,8,15,71,58,13,65
National League South 2017/18,Bath City,42,17,12,13,64,48,16,63
National League South 2017/18,Welling United,42,17,10,15,68,59,9,61
National League South 2017/18,Wealdstone,42,16,11,15,64,62,2,59
National League South 2017/18,Weston-s-Mare,42,16,7,19,66,73,-7,55
National League South 2017/18,Chippenham Town,42,15,9,18,64,70,-6,54
National League South 2017/18,Gloucester,42,15,8,19,56,70,-14,53
National League South 2017/18,East Thurrock United,42,13,11,18,68,84,-16,50
National League South 2017/18,Oxford City,42,13,10,19,60,69,-9,49
National League South 2017/18,Concord Rangers,42,12,10,20,46,62,-16,46
National League South 2017/18,Eastbourne Borough,42,13,7,22,57,80,-23,46
National League South 2017/18,Hungerford Town,42,12,7,23,45,68,-23,43
National League South 2017/18,Poole Town,42,11,9,22,47,73,-26,42
National League South 2017/18,Whitehawk,42,8,10,24,51,89,-38,34
National League South 2017/18,Bognor Regis Town,42,5,12,25,41,78,-37,27
National League South 2018/19,Torquay United,42,27,7,8,93,41,52,88
National League South 2018/19,Woking,42,23,9,10,76,49,27,78
National League South 2018/19,Welling United,42,23,7,12,70,47,23,76
National League South 2018/19,Chelmsford,42,21,9,12,68,50,18,72
National League South 2018/19,Bath City,42,20,11,11,58,36,22,71
National League South 2018/19,Concord Rangers *,42,20,13,9,69,48,21,70
National League South 2018/19,Wealdstone,42,18,12,12,62,50,12,66
National League South 2018/19,Billericay Town,42,19,8,15,72,65,7,65
National League South 2018/19,St Albans,42,18,10,14,67,64,3,64
National League South 2018/19,Dartford,42,18,10,14,52,58,-6,64
National League South 2018/19,Slough,42,17,12,13,56,50,6,63
National League South 2018/19,Oxford City,42,17,5,20,64,63,1,56
National League South 2018/19,Chippenham Town,42,16,7,19,57,64,-7,55
National League South 2018/19,Dulwich Hamlet,42,13,10,19,52,65,-13,49
National League South 2018/19,Hampton & Richmond,42,13,10,19,49,66,-17,49
National League South 2018/19,Hemel Hempstead,42,12,12,18,52,67,-15,48
National League South 2018/19,Gloucester,42,12,11,19,35,54,-19,47
National League South 2018/19,Eastbourne Borough,42,10,12,20,52,65,-13,42
National League South 2018/19,Hungerford Town,42,11,9,22,45,72,-27,42
National League South 2018/19,Truro City,42,9,12,21,63,87,-24,39
National League South 2018/19,East Thurrock United,42,10,7,25,42,63,-21,37
National League South 2018/19,Weston-s-Mare,42,8,11,23,50,80,-30,35
National League South 2019/20,Wealdstone,33,22,4,7,69,35,34,70
National League South 2019/20,Havant and Waterlooville,34,19,10,5,64,37,27,67
National League South 2019/20,Weymouth,35,17,12,6,60,35,25,63
National League South 2019/20,Bath City,35,18,9,8,50,37,13,63
National League South 2019/20,Slough,35,17,9,9,51,38,13,60
National League South 2019/20,Dartford,34,16,8,10,60,46,14,56
National League South 2019/20,Dorking Wanderers,35,14,8,13,58,56,2,50
National League South 2019/20,Hampton & Richmond,33,14,5,14,51,50,1,47
National League South 2019/20,Maidstone Utd,33,12,9,12,48,44,4,45
National League South 2019/20,Chelmsford,34,11,11,12,55,56,-1,44
National League South 2019/20,Hemel Hempstead,34,12,8,14,36,43,-7,44
National League South 2019/20,Chippenham Town,35,10,12,13,39,45,-6,42
National League South 2019/20,Welling United,34,12,6,16,38,46,-8,42
National League South 2019/20,Oxford City,34,11,9,14,47,60,-13,42
National League South 2019/20,Eastbourne Borough,33,8,14,11,38,54,-16,38
National League South 2019/20,Dulwich Hamlet,35,9,10,16,51,50,1,37
National League South 2019/20,Concord Rangers,32,10,7,15,44,48,-4,37
National League South 2019/20,Billericay Town,32,8,13,11,46,55,-9,37
National League South 2019/20,St Albans,35,9,10,16,41,54,-13,37
National League South 2019/20,Tonbridge Angels,31,9,9,13,46,54,-8,36
National League South 2019/20,Braintree Town,35,10,5,20,44,67,-23,35
National League South 2019/20,Hungerford Town,33,8,4,21,38,64,-26,28
National League South 2020/21,Dartford,5,4,1,0,6,2,4,13
National League South 2020/21,Hungerford Town,5,4,0,1,10,3,7,12
National League South 2020/21,Maidstone Utd,5,3,1,1,14,5,9,10
National League South 2020/21,St Albans,4,3,1,0,8,3,5,10
National League South 2020/21,Ebbsfleet United,5,3,1,1,11,7,4,10
National League South 2020/21,Eastbourne Borough,5,3,1,1,9,7,2,10
National League South 2020/21,Dorking Wanderers,4,3,0,1,10,3,7,9
National League South 2020/21,Oxford City,4,2,1,1,7,3,4,7
National League South 2020/21,Slough,4,2,1,1,8,8,0,7
National League South 2020/21,Chelmsford,5,1,3,1,3,3,0,6
National League South 2020/21,Chippenham Town,5,2,0,3,4,8,-4,6
National League South 2020/21,Havant and Waterlooville,3,1,1,1,5,5,0,4
National League South 2020/21,Hampton & Richmond,4,1,1,2,3,3,0,4
National League South 2020/21,Bath City,4,1,0,3,3,5,-2,3
National League South 2020/21,Tonbridge Angels,3,1,0,2,2,6,-4,3
National League South 2020/21,Hemel Hempstead,4,1,0,3,6,12,-6,3
National League South 2020/21,Dulwich Hamlet,3,0,2,1,1,3,-2,2
National League South 2020/21,Welling United,3,0,1,2,6,8,-2,1
National League South 2020/21,Concord Rangers,3,0,1,2,1,8,-7,1
National League South 2020/21,Billericay Town,4,0,0,4,2,8,-6,0
National League South 2020/21,Braintree Town,4,0,0,4,3,12,-9,0
Blue Square Premier 2009/10,Stevenage,44,30,9,5,79,24,55,99
Blue Square Premier 2009/10,Luton Town,44,26,10,8,84,40,44,88
Blue Square Premier 2009/10,Oxford United,44,25,11,8,64,31,33,86
Blue Square Premier 2009/10,Rushden & Diamonds,44,22,13,9,77,39,38,79
Blue Square Premier 2009/10,York City,44,22,12,10,62,35,27,78
Blue Square Premier 2009/10,Kettering Town,44,18,12,14,51,41,10,66
Blue Square Premier 2009/10,Crawley Town,44,19,9,16,50,57,-7,66
Blue Square Premier 2009/10,AFC Wimbledon,44,18,10,16,61,47,14,64
Blue Square Premier 2009/10,Mansfield Town,44,17,11,16,69,60,9,62
Blue Square Premier 2009/10,Cambridge United,44,15,14,15,65,53,12,59
Blue Square Premier 2009/10,Wrexham,44,15,13,16,45,39,6,58
Blue Square Premier 2009/10,Salisbury City *,44,21,5,18,58,63,-5,58
Blue Square Premier 2009/10,Kidderminster Harriers,44,15,12,17,57,52,5,57
Blue Square Premier 2009/10,Altrincham,44,13,15,16,53,51,2,54
Blue Square Premier 2009/10,Barrow,44,13,13,18,50,67,-17,52
Blue Square Premier 2009/10,Tamworth,44,11,16,17,42,52,-10,49
Blue Square Premier 2009/10,Hayes & Yeading,44,12,12,20,59,85,-26,48
Blue Square Premier 2009/10,Histon,44,11,13,20,44,67,-23,46
Blue Square Premier 2009/10,Eastbourne Borough,44,11,13,20,42,72,-30,46
Blue Square Premier 2009/10,Gateshead *,44,13,7,24,46,69,-23,45
Blue Square Premier 2009/10,Forest Green Rovers,44,12,9,23,50,76,-26,45
Blue Square Premier 2009/10,Ebbsfleet United,44,12,8,24,50,82,-32,44
Blue Square Premier 2009/10,Grays Athletic *,44,5,13,26,35,91,-56,26
Blue Square Premier 2010/11,Crawley Town,46,31,12,3,93,30,63,105
Blue Square Premier 2010/11,AFC Wimbledon,46,27,9,10,83,47,36,90
Blue Square Premier 2010/11,Luton Town,46,23,15,8,85,37,48,84
Blue Square Premier 2010/11,Wrexham,46,22,15,9,66,49,17,81
Blue Square Premier 2010/11,Fleetwood Town,46,22,12,12,68,42,26,78
Blue Square Premier 2010/11,Kidderminster Harriers *,46,20,17,9,74,60,14,72
Blue Square Premier 2010/11,Darlington,46,18,17,11,61,42,19,71
Blue Square Premier 2010/11,York City,46,19,14,13,55,50,5,71
Blue Square Premier 2010/11,Newport County AFC,46,18,15,13,78,60,18,69
Blue Square Premier 2010/11,Bath City,46,16,15,15,64,68,-4,63
Blue Square Premier 2010/11,Grimsby Town,46,15,17,14,72,62,10,62
Blue Square Premier 2010/11,Mansfield Town,46,17,10,19,73,75,-2,61
Blue Square Premier 2010/11,Rushden & Diamonds *,46,16,14,16,65,62,3,57
Blue Square Premier 2010/11,Gateshead,46,14,15,17,65,68,-3,57
Blue Square Premier 2010/11,Kettering Town *,46,15,13,18,64,75,-11,56
Blue Square Premier 2010/11,Hayes & Yeading,46,15,6,25,57,81,-24,51
Blue Square Premier 2010/11,Cambridge United,46,11,17,18,53,61,-8,50
Blue Square Premier 2010/11,Barrow,46,12,14,20,52,67,-15,50
Blue Square Premier 2010/11,Tamworth,46,12,13,21,62,83,-21,49
Blue Square Premier 2010/11,Forest Green Rovers,46,10,16,20,53,72,-19,46
Blue Square Premier 2010/11,Southport,46,11,13,22,56,77,-21,46
Blue Square Premier 2010/11,Altrincham,46,11,11,24,47,87,-40,44
Blue Square Premier 2010/11,Eastbourne Borough,46,10,9,27,62,104,-42,39
Blue Square Premier 2010/11,Histon *,46,8,9,29,41,90,-49,28
Blue Square Premier 2011/12,Fleetwood Town,46,31,10,5,102,48,54,103
Blue Square Premier 2011/12,Wrexham,46,30,8,8,85,33,52,98
Blue Square Premier 2011/12,Mansfield Town,46,25,14,7,87,48,39,89
Blue Square Premier 2011/12,York City,46,23,14,9,81,45,36,83
Blue Square Premier 2011/12,Luton Town,46,22,15,9,78,42,36,81
Blue Square Premier 2011/12,Kidderminster Harriers,46,22,10,14,82,63,19,76
Blue Square Premier 2011/12,Southport,46,21,13,12,72,69,3,76
Blue Square Premier 2011/12,Gateshead,46,21,11,14,69,62,7,74
Blue Square Premier 2011/12,Cambridge United,46,19,14,13,57,41,16,71
Blue Square Premier 2011/12,Forest Green Rovers,46,19,13,14,66,45,21,70
Blue Square Premier 2011/12,Grimsby Town,46,19,13,14,79,60,19,70
Blue Square Premier 2011/12,Braintree Town,46,17,11,18,76,80,-4,62
Blue Square Premier 2011/12,Barrow,46,17,9,20,62,76,-14,60
Blue Square Premier 2011/12,Ebbsfleet United,46,14,12,20,69,84,-15,54
Blue Square Premier 2011/12,Alfreton Town,46,15,9,22,62,86,-24,54
Blue Square Premier 2011/12,Stockport County,46,12,15,19,58,74,-16,51
Blue Square Premier 2011/12,Lincoln City,46,13,10,23,56,66,-10,49
Blue Square Premier 2011/12,Tamworth,46,11,15,20,47,70,-23,48
Blue Square Premier 2011/12,Newport County AFC,46,11,14,21,53,65,-12,47
Blue Square Premier 2011/12,AFC Telford United,46,10,16,20,45,65,-20,46
Blue Square Premier 2011/12,Hayes & Yeading,46,11,8,27,58,90,-32,41
Blue Square Premier 2011/12,Darlington *,46,11,13,22,47,73,-26,36
Blue Square Premier 2011/12,Bath City,46,7,10,29,43,89,-46,31
Blue Square Premier 2011/12,Kettering Town *,46,8,9,29,40,100,-60,30
Blue Square Premier 2012/13,Mansfield Town,46,30,5,11,92,52,40,95
Blue Square Premier 2012/13,Kidderminster Harriers,46,28,9,9,82,40,42,93
Blue Square Premier 2012/13,Newport County AFC,46,25,10,11,85,60,25,85
Blue Square Premier 2012/13,Grimsby Town,46,23,14,9,70,38,32,83
Blue Square Premier 2012/13,Wrexham,46,22,14,10,74,45,29,80
Blue Square Premier 2012/13,Hereford FC,46,19,13,14,73,63,10,70
Blue Square Premier 2012/13,Luton Town,46,18,13,15,70,62,8,67
Blue Square Premier 2012/13,Dartford,46,19,9,18,67,63,4,66
Blue Square Premier 2012/13,Braintree Town,46,19,9,18,63,72,-9,66
Blue Square Premier 2012/13,Forest Green Rovers,46,18,11,17,63,49,14,65
Blue Square Premier 2012/13,Macclesfield Town,46,17,12,17,65,70,-5,63
Blue Square Premier 2012/13,Woking,46,18,8,20,73,81,-8,62
Blue Square Premier 2012/13,Alfreton Town,46,16,12,18,69,74,-5,60
Blue Square Premier 2012/13,Cambridge United,46,15,14,17,68,69,-1,59
Blue Square Premier 2012/13,Nuneaton,46,14,15,17,55,63,-8,57
Blue Square Premier 2012/13,Lincoln City,46,15,11,20,66,73,-7,56
Blue Square Premier 2012/13,Gateshead,46,13,16,17,58,61,-3,55
Blue Square Premier 2012/13,Hyde,46,16,7,23,63,75,-12,55
Blue Square Premier 2012/13,Tamworth,46,15,10,21,55,69,-14,55
Blue Square Premier 2012/13,Southport,46,14,12,20,72,86,-14,54
Blue Square Premier 2012/13,Stockport County,46,13,11,22,57,76,-19,50
Blue Square Premier 2012/13,Barrow,46,11,13,22,45,83,-38,46
Blue Square Premier 2012/13,Ebbsfleet United,46,8,15,23,55,89,-34,39
Blue Square Premier 2012/13,AFC Telford United,46,6,17,23,52,79,-27,35
Skrill Premier 2013/14,Luton Town,46,30,11,5,102,35,67,101
Skrill Premier 2013/14,Cambridge United,46,23,13,10,72,35,37,82
Skrill Premier 2013/14,Gateshead,46,22,13,11,72,50,22,79
Skrill Premier 2013/14,Grimsby Town,46,22,12,12,65,46,19,78
Skrill Premier 2013/14,FC Halifax,46,22,11,13,85,58,27,77
Skrill Premier 2013/14,Braintree Town,46,21,11,14,57,39,18,74
Skrill Premier 2013/14,Kidderminster Harriers,46,20,12,14,66,59,7,72
Skrill Premier 2013/14,Barnet,46,19,13,14,58,53,5,70
Skrill Premier 2013/14,Woking,46,20,8,18,66,69,-3,68
Skrill Premier 2013/14,Forest Green Rovers,46,19,10,17,80,66,14,67
Skrill Premier 2013/14,Alfreton Town *,46,21,7,18,69,74,-5,67
Skrill Premier 2013/14,Salisbury City,46,19,10,17,58,63,-5,67
Skrill Premier 2013/14,Nuneaton,46,18,12,16,54,60,-6,66
Skrill Premier 2013/14,Lincoln City,46,17,14,15,60,59,1,65
Skrill Premier 2013/14,Macclesfield Town,46,18,7,21,62,63,-1,61
Skrill Premier 2013/14,Welling United,46,16,12,18,59,61,-2,60
Skrill Premier 2013/14,Wrexham,46,16,11,19,61,61,0,59
Skrill Premier 2013/14,Southport,46,14,11,21,53,71,-18,53
Skrill Premier 2013/14,Aldershot Town *,46,16,13,17,69,62,7,51
Skrill Premier 2013/14,Hereford FC,46,13,12,21,44,63,-19,51
Skrill Premier 2013/14,Chester FC,46,12,15,19,49,70,-21,51
Skrill Premier 2013/14,Dartford,46,12,8,26,49,74,-25,44
Skrill Premier 2013/14,Tamworth,46,10,9,27,43,81,-38,39
Skrill Premier 2013/14,Hyde,46,1,7,38,38,119,-81,10
Vanarama Conference 2014/15,Barnet,46,28,8,10,94,46,48,92
Vanarama Conference 2014/15,Bristol Rovers,46,25,16,5,73,34,39,91
Vanarama Conference 2014/15,Grimsby Town,46,25,11,10,74,40,34,86
Vanarama Conference 2014/15,Eastleigh,46,24,10,12,87,61,26,82
Vanarama Conference 2014/15,Forest Green Rovers *,46,22,16,8,80,54,26,79
Vanarama Conference 2014/15,Macclesfield Town,46,21,15,10,60,46,14,78
Vanarama Conference 2014/15,Woking,46,21,13,12,77,52,25,76
Vanarama Conference 2014/15,Dover,46,19,11,16,69,58,11,68
Vanarama Conference 2014/15,FC Halifax,46,17,15,14,60,54,6,66
Vanarama Conference 2014/15,Gateshead,46,17,15,14,66,62,4,66
Vanarama Conference 2014/15,Wrexham,46,17,15,14,56,52,4,66
Vanarama Conference 2014/15,Chester FC,46,19,6,21,64,76,-12,63
Vanarama Conference 2014/15,Torquay United,46,16,13,17,64,60,4,61
Vanarama Conference 2014/15,Braintree Town,46,18,5,23,56,57,-1,59
Vanarama Conference 2014/15,Lincoln City,46,16,10,20,62,71,-9,58
Vanarama Conference 2014/15,Kidderminster Harriers,46,15,12,19,51,60,-9,57
Vanarama Conference 2014/15,Altrincham,46,16,8,22,54,73,-19,56
Vanarama Conference 2014/15,Aldershot Town,46,14,11,21,51,61,-10,53
Vanarama Conference 2014/15,Southport,46,13,12,21,47,72,-25,51
Vanarama Conference 2014/15,Welling United,46,11,12,23,52,73,-21,45
Vanarama Conference 2014/15,Alfreton Town,46,12,9,25,49,90,-41,45
Vanarama Conference 2014/15,Dartford,46,8,15,23,44,74,-30,39
Vanarama Conference 2014/15,AFC Telford United *,46,10,9,27,58,84,-26,36
Vanarama Conference 2014/15,Nuneaton *,46,10,9,27,38,76,-38,36
Vanarama National League 2015/16,Cheltenham Town,46,30,11,5,87,30,57,101
Vanarama National League 2015/16,Forest Green Rovers,46,26,11,9,69,42,27,89
Vanarama National League 2015/16,Braintree Town,46,23,12,11,56,38,18,81
Vanarama National League 2015/16,Grimsby Town,46,22,14,10,82,45,37,80
Vanarama National League 2015/16,Dover,46,23,11,12,75,53,22,80
Vanarama National League 2015/16,Tranmere Rovers,46,22,12,12,61,44,17,78
Vanarama National League 2015/16,Eastleigh,46,21,12,13,64,53,11,75
Vanarama National League 2015/16,Wrexham,46,20,9,17,71,56,15,69
Vanarama National League 2015/16,Gateshead,46,19,10,17,59,70,-11,67
Vanarama National League 2015/16,Macclesfield Town,46,19,9,18,60,48,12,66
Vanarama National League 2015/16,Barrow,46,17,14,15,64,71,-7,65
Vanarama National League 2015/16,Woking,46,17,10,19,71,68,3,61
Vanarama National League 2015/16,Lincoln City,46,16,13,17,69,68,1,61
Vanarama National League 2015/16,Bromley,46,17,9,20,67,72,-5,60
Vanarama National League 2015/16,Aldershot Town,46,16,8,22,54,72,-18,56
Vanarama National League 2015/16,Southport,46,14,13,19,52,65,-13,55
Vanarama National League 2015/16,Chester FC,46,14,12,20,67,71,-4,54
Vanarama National League 2015/16,Torquay United,46,13,12,21,54,76,-22,51
Vanarama National League 2015/16,Boreham Wood,46,12,14,20,44,49,-5,50
Vanarama National League 2015/16,Guiseley,46,11,16,19,47,70,-23,49
Vanarama National League 2015/16,FC Halifax,46,12,12,22,55,82,-27,48
Vanarama National League 2015/16,Altrincham,46,10,14,22,48,73,-25,44
Vanarama National League 2015/16,Kidderminster Harriers,46,9,13,24,49,71,-22,40
Vanarama National League 2015/16,Welling United,46,8,11,27,35,73,-38,35
National League - Play-Offs 2016/17,Lincoln City,46,30,9,7,83,40,43,99
National League - Play-Offs 2016/17,Tranmere Rovers,46,29,8,9,79,39,40,95
National League - Play-Offs 2016/17,Forest Green Rovers,46,25,11,10,88,56,32,86
National League - Play-Offs 2016/17,Dagenham & Redbridge,46,26,6,14,79,53,26,84
National League - Play-Offs 2016/17,Aldershot Town,46,23,13,10,66,37,29,82
National League - Play-Offs 2016/17,Dover,46,24,7,15,85,63,22,79
National League - Play-Offs 2016/17,Barrow,46,20,15,11,72,53,19,75
National League - Play-Offs 2016/17,Gateshead,46,19,13,14,72,51,21,70
National League - Play-Offs 2016/17,Macclesfield Town,46,20,8,18,64,57,7,68
National League - Play-Offs 2016/17,Bromley,46,18,8,20,59,66,-7,62
National League - Play-Offs 2016/17,Boreham Wood,46,15,13,18,49,48,1,58
National League - Play-Offs 2016/17,Sutton United,46,15,13,18,61,63,-2,58
National League - Play-Offs 2016/17,Wrexham,46,15,13,18,47,61,-14,58
National League - Play-Offs 2016/17,Maidstone Utd,46,16,10,20,59,75,-16,58
National League - Play-Offs 2016/17,Eastleigh,46,14,15,17,56,63,-7,57
National League - Play-Offs 2016/17,Solihull Moors,46,15,10,21,62,75,-13,55
National League - Play-Offs 2016/17,Torquay United,46,14,11,21,54,61,-7,53
National League - Play-Offs 2016/17,Woking,46,14,11,21,66,80,-14,53
National League - Play-Offs 2016/17,Chester FC,46,14,10,22,63,71,-8,52
National League - Play-Offs 2016/17,Guiseley,46,13,12,21,50,67,-17,51
National League - Play-Offs 2016/17,York City,46,11,17,18,55,70,-15,50
National League - Play-Offs 2016/17,Braintree Town,46,13,9,24,51,76,-25,48
National League - Play-Offs 2016/17,Southport,46,10,9,27,52,97,-45,39
National League - Play-Offs 2016/17,North Ferriby Utd,46,12,3,31,32,82,-50,39
National League 2017/18,Macclesfield Town,46,27,11,8,67,46,21,92
National League 2017/18,Tranmere Rovers,46,24,10,12,78,46,32,82
National League 2017/18,Sutton United,46,23,10,13,67,53,14,79
National League 2017/18,Boreham Wood,46,20,15,11,64,47,17,75
National League 2017/18,Aldershot Town,46,20,15,11,64,52,12,75
National League 2017/18,Ebbsfleet United,46,19,17,10,64,50,14,74
National League 2017/18,AFC Fylde,46,20,13,13,82,56,26,73
National League 2017/18,Dover,46,20,13,13,62,44,18,73
National League 2017/18,Bromley,46,19,13,14,75,58,17,70
National League 2017/18,Wrexham,46,17,19,10,49,39,10,70
National League 2017/18,Dagenham & Redbridge,46,19,11,16,69,62,7,68
National League 2017/18,Maidenhead United,46,17,13,16,65,66,-1,64
National League 2017/18,Leyton Orient,46,16,12,18,58,56,2,60
National League 2017/18,Eastleigh,46,13,17,16,65,72,-7,56
National League 2017/18,Hartlepool United,46,14,14,18,53,63,-10,56
National League 2017/18,FC Halifax,46,13,16,17,48,58,-10,55
National League 2017/18,Gateshead,46,12,18,16,62,58,4,54
National League 2017/18,Solihull Moors,46,14,12,20,49,60,-11,54
National League 2017/18,Maidstone Utd,46,13,15,18,52,64,-12,54
National League 2017/18,Barrow,46,11,16,19,51,63,-12,49
National League 2017/18,Woking,46,13,9,24,55,76,-21,48
National League 2017/18,Torquay United,46,10,12,24,45,73,-28,42
National League 2017/18,Chester FC,46,8,13,25,42,79,-37,37
National League 2017/18,Guiseley,46,7,12,27,44,89,-45,33
National League 2018/19,Leyton Orient,46,25,14,7,73,35,38,89
National League 2018/19,Solihull Moors,46,25,11,10,73,43,30,86
National League 2018/19,Salford City,46,25,10,11,77,45,32,85
National League 2018/19,Wrexham,46,25,9,12,58,39,19,84
National League 2018/19,AFC Fylde,46,22,15,9,72,41,31,81
National League 2018/19,Harrogate Town,46,21,11,14,78,57,21,74
National League 2018/19,Eastleigh,46,22,8,16,62,63,-1,74
National League 2018/19,Ebbsfleet United,46,18,13,15,64,50,14,67
National League 2018/19,Sutton United,46,17,14,15,55,60,-5,65
National League 2018/19,Barrow,46,17,13,16,52,51,1,64
National League 2018/19,Bromley,46,16,12,18,68,69,-1,60
National League 2018/19,Barnet,46,16,12,18,45,50,-5,60
National League 2018/19,Dover,46,16,12,18,58,64,-6,60
National League 2018/19,Chesterfield,46,14,17,15,55,53,2,59
National League 2018/19,FC Halifax,46,13,20,13,44,43,1,59
National League 2018/19,Hartlepool United,46,15,14,17,56,62,-6,59
National League 2018/19,Gateshead,46,19,9,18,52,48,4,57
National League 2018/19,Dagenham & Redbridge,46,15,11,20,50,56,-6,56
National League 2018/19,Maidenhead United,46,16,6,24,45,70,-25,54
National League 2018/19,Boreham Wood,46,12,16,18,53,65,-12,52
National League 2018/19,Aldershot Town,46,11,11,24,38,67,-29,44
National League 2018/19,Havant and Waterlooville,46,9,13,24,62,84,-22,40
National League 2018/19,Braintree Town,46,11,8,27,48,78,-30,38
National League 2018/19,Maidstone Utd,46,9,7,30,37,82,-45,34
National League 2019/20,Barrow,37,21,7,9,68,39,29,70
National League 2019/20,Harrogate Town,37,19,9,9,61,44,17,66
National League 2019/20,Notts County,38,17,12,9,61,38,23,63
National League 2019/20,Yeovil Town,37,17,9,11,61,44,17,60
National League 2019/20,Boreham Wood,37,16,12,9,55,40,15,60
National League 2019/20,FC Halifax,37,17,7,13,50,49,1,58
National League 2019/20,Stockport County,39,16,10,13,51,54,-3,58
National League 2019/20,Solihull Moors,38,15,10,13,48,37,11,55
National League 2019/20,Hartlepool United,39,14,13,12,56,50,6,55
National League 2019/20,Woking,38,15,10,13,50,55,-5,55
National League 2019/20,Barnet,35,14,12,9,52,42,10,54
National League 2019/20,Dover,38,15,9,14,49,49,0,54
National League 2019/20,Bromley,38,14,10,14,57,52,5,52
National League 2019/20,Sutton United,38,12,14,12,47,42,5,50
National League 2019/20,Torquay United,36,14,6,16,56,61,-5,48
National League 2019/20,Aldershot Town,39,12,10,17,43,55,-12,46
National League 2019/20,Eastleigh,37,11,13,13,43,55,-12,46
National League 2019/20,Dagenham & Redbridge,37,11,11,15,40,44,-4,44
National League 2019/20,Chesterfield,38,11,11,16,55,65,-10,44
National League 2019/20,Wrexham,37,11,10,16,46,49,-3,43
National League 2019/20,Ebbsfleet United,39,10,12,17,47,68,-21,42
National League 2019/20,Maidenhead United,38,12,5,21,44,58,-14,41
National League 2019/20,AFC Fylde,37,9,12,16,44,60,-16,39
National League 2019/20,Chorley,38,4,14,20,31,65,-34,26
National League 2020/21,Torquay United,7,6,0,1,17,5,12,18
National League 2020/21,Stockport County,7,4,1,2,13,7,6,13
National League 2020/21,Sutton United,5,4,0,1,8,3,5,12
National League 2020/21,Maidenhead United,7,4,0,3,11,14,-3,12
National League 2020/21,Eastleigh,6,3,2,1,14,9,5,11
National League 2020/21,Hartlepool United,6,3,2,1,9,8,1,11
National League 2020/21,Solihull Moors,6,3,1,2,9,5,4,10
National League 2020/21,Wealdstone,6,3,1,2,14,15,-1,10
National League 2020/21,Woking,7,3,1,3,7,9,-2,10
National League 2020/21,Notts County,5,3,0,2,10,7,3,9
National League 2020/21,Bromley,5,2,1,2,9,7,2,7
National League 2020/21,Boreham Wood,5,2,1,2,5,3,2,7
National League 2020/21,Wrexham,6,2,1,3,6,7,-1,7
National League 2020/21,Weymouth,7,2,1,4,6,8,-2,7
National League 2020/21,Barnet,5,2,1,2,6,10,-4,7
National League 2020/21,Kings Lynn Town,7,2,1,4,11,19,-8,7
National League 2020/21,Chesterfield,6,2,0,4,10,9,1,6
National League 2020/21,FC Halifax,5,1,3,1,4,3,1,6
National League 2020/21,Altrincham,5,1,3,1,4,5,-1,6
National League 2020/21,Dover,7,2,0,5,5,17,-12,6
National League 2020/21,Aldershot Town,5,1,1,3,10,10,0,4
National League 2020/21,Yeovil Town,7,0,4,3,6,9,-3,4
National League 2020/21,Dagenham & Redbridge,6,1,1,4,3,8,-5,4
Women's World Cup Qualifying - Group 2 2017/18,Switzerland Women,5,5,0,0,15,3,12,15
Women's World Cup Qualifying - Group 2 2017/18,Scotland Women,5,4,0,1,12,3,9,12
Women's World Cup Qualifying - Group 2 2017/18,Poland Women,5,2,1,2,10,8,2,7
Women's World Cup Qualifying - Group 2 2017/18,Albania Women,7,1,1,5,5,20,-15,4
Women's World Cup Qualifying - Group 2 2017/18,Belarus Women,6,1,0,5,4,12,-8,3
Women's World Cup Qualifying - Group 4 2017/18,Sweden Women,5,5,0,0,18,1,17,15
Women's World Cup Qualifying - Group 4 2017/18,Denmark Ladies,5,4,0,1,16,5,11,12
Women's World Cup Qualifying - Group 4 2017/18,Ukraine Women,5,2,1,2,6,7,-1,7
Women's World Cup Qualifying - Group 4 2017/18,Hungary Women,6,1,1,4,7,19,-12,4
Women's World Cup Qualifying - Group 4 2017/18,Croatia Women,7,0,2,5,4,19,-15,2
Women's World Cup Qualifying - Group 5 2017/18,Iceland Women,6,5,1,0,21,3,18,16
Women's World Cup Qualifying - Group 5 2017/18,Germany Women,6,5,0,1,28,3,25,15
Women's World Cup Qualifying - Group 5 2017/18,Czech Republic Women,5,2,1,2,13,6,7,7
Women's World Cup Qualifying - Group 5 2017/18,Slovenia Women,7,2,0,5,9,18,-9,6
Women's World Cup Qualifying - Group 5 2017/18,Faroe Islands Women,6,0,0,6,0,41,-41,0
Women's World Cup Qualifying - Group 6 2017/18,Italy Ladies,7,7,0,0,18,2,16,21
Women's World Cup Qualifying - Group 6 2017/18,Belgium Women,6,4,1,1,25,5,20,13
Women's World Cup Qualifying - Group 6 2017/18,Portugal Women,5,1,1,3,9,6,3,4
Women's World Cup Qualifying - Group 6 2017/18,Romania Women,5,1,1,3,5,8,-3,4
Women's World Cup Qualifying - Group 6 2017/18,Moldova Women,7,0,1,6,2,38,-36,1
Women's World Cup Qualifying - Group 7 2017/18,Spain Women,6,6,0,0,17,1,16,18
Women's World Cup Qualifying - Group 7 2017/18,Austria Women,6,3,1,2,9,6,3,10
Women's World Cup Qualifying - Group 7 2017/18,Finland Ladies,5,2,1,2,5,4,1,7
Women's World Cup Qualifying - Group 7 2017/18,Serbia Women,6,2,1,3,5,8,-3,7
Women's World Cup Qualifying - Group 7 2017/18,Israel Women,7,0,1,6,0,17,-17,1
Women's World Cup Qualifying - Group 1 2018/19,England Women,8,7,1,0,29,1,28,22
Women's World Cup Qualifying - Group 1 2018/19,Wales Women,8,5,2,1,7,3,4,17
Women's World Cup Qualifying - Group 1 2018/19,Russia Ladies,8,4,1,3,16,13,3,13
Women's World Cup Qualifying - Group 1 2018/19,Bosnia and Herzegovina Women,8,1,0,7,3,19,-16,3
Women's World Cup Qualifying - Group 1 2018/19,Kazakhstan Women,8,1,0,7,2,21,-19,3
Women's World Cup Qualifying - Group 2 2018/19,Scotland Women,8,7,0,1,19,7,12,21
Women's World Cup Qualifying - Group 2 2018/19,Switzerland Women,8,6,1,1,21,5,16,19
Women's World Cup Qualifying - Group 2 2018/19,Poland Women,8,3,2,3,16,12,4,11
Women's World Cup Qualifying - Group 2 2018/19,Albania Women,8,1,1,6,6,22,-16,4
Women's World Cup Qualifying - Group 2 2018/19,Belarus Women,8,1,0,7,5,21,-16,3
Women's World Cup Qualifying - Group 3 2018/19,Norway Women,8,7,0,1,22,4,18,21
Women's World Cup Qualifying - Group 3 2018/19,Holland Women,8,6,1,1,22,2,20,19
Women's World Cup Qualifying - Group 3 2018/19,Republic of Ireland Women,8,4,1,3,10,6,4,13
Women's World Cup Qualifying - Group 3 2018/19,Slovakia Women,8,1,0,7,4,23,-19,3
Women's World Cup Qualifying - Group 3 2018/19,Northern Ireland Women,8,1,0,7,4,27,-23,3
Women's World Cup Qualifying - Group 4 2018/19,Sweden Women,8,7,0,1,22,2,20,21
Women's World Cup Qualifying - Group 4 2018/19,Denmark Ladies,8,5,1,2,22,8,14,16
Women's World Cup Qualifying - Group 4 2018/19,Ukraine Women,8,4,1,3,9,10,-1,13
Women's World Cup Qualifying - Group 4 2018/19,Hungary Women,8,1,1,6,8,26,-18,4
Women's World Cup Qualifying - Group 4 2018/19,Croatia Women,8,0,3,5,5,20,-15,3
Women's World Cup Qualifying - Group 5 2018/19,Germany Women,8,7,0,1,38,3,35,21
Women's World Cup Qualifying - Group 5 2018/19,Iceland Women,8,5,2,1,22,6,16,17
Women's World Cup Qualifying - Group 5 2018/19,Czech Republic Women,8,4,2,2,20,8,12,14
Women's World Cup Qualifying - Group 5 2018/19,Slovenia Women,8,2,0,6,9,20,-11,6
Women's World Cup Qualifying - Group 5 2018/19,Faroe Islands Women,8,0,0,8,1,53,-52,0
Women's World Cup Qualifying - Group 6 2018/19,Italy Ladies,8,7,0,1,19,4,15,21
Women's World Cup Qualifying - Group 6 2018/19,Belgium Women,8,6,1,1,28,6,22,19
Women's World Cup Qualifying - Group 6 2018/19,Portugal Women,8,3,2,3,22,8,14,11
Women's World Cup Qualifying - Group 6 2018/19,Romania Women,8,1,2,5,7,15,-8,5
Women's World Cup Qualifying - Group 6 2018/19,Moldova Women,8,0,1,7,2,45,-43,1
Women's World Cup Qualifying - Group 7 2018/19,Spain Women,8,8,0,0,25,2,23,24
Women's World Cup Qualifying - Group 7 2018/19,Austria Women,8,5,1,2,19,7,12,16
Women's World Cup Qualifying - Group 7 2018/19,Finland Ladies,8,3,1,4,9,13,-4,10
Women's World Cup Qualifying - Group 7 2018/19,Serbia Women,8,2,1,5,5,13,-8,7
Women's World Cup Qualifying - Group 7 2018/19,Israel Women,8,0,1,7,0,23,-23,1
World Cup Qualifying - Group One 2008/09,Denmark,6,5,1,0,13,2,11,16
World Cup Qualifying - Group One 2008/09,Hungary,6,4,1,1,8,2,6,13
World Cup Qualifying - Group One 2008/09,Portugal,6,2,3,1,8,4,4,9
World Cup Qualifying - Group One 2008/09,Sweden,6,2,3,1,6,2,4,9
World Cup Qualifying - Group One 2008/09,Albania,8,1,3,4,4,8,-4,6
World Cup Qualifying - Group One 2008/09,Malta,8,0,1,7,0,21,-21,1
World Cup Qualifying - Group Eight 2009/10,Italy,10,7,3,0,18,7,11,24
World Cup Qualifying - Group Eight 2009/10,Republic of Ireland,10,4,6,0,12,8,4,18
World Cup Qualifying - Group Eight 2009/10,Bulgaria,10,3,5,2,17,13,4,14
World Cup Qualifying - Group Eight 2009/10,Cyprus,10,2,3,5,14,16,-2,9
World Cup Qualifying - Group Eight 2009/10,Montenegro,10,1,6,3,9,14,-5,9
World Cup Qualifying - Group Eight 2009/10,Georgia,10,0,3,7,7,19,-12,3
World Cup Qualifying - Group Five 2009/10,Spain,10,10,0,0,28,5,23,30
World Cup Qualifying - Group Five 2009/10,Bosnia and Herzegovina,10,6,1,3,25,13,12,19
World Cup Qualifying - Group Five 2009/10,Turkey,10,4,3,3,13,10,3,15
World Cup Qualifying - Group Five 2009/10,Belgium,10,3,1,6,13,20,-7,10
World Cup Qualifying - Group Five 2009/10,Estonia,10,2,2,6,9,24,-15,8
World Cup Qualifying - Group Five 2009/10,Armenia,10,1,1,8,6,23,-17,4
World Cup Qualifying - Group Four 2009/10,Germany,10,8,2,0,26,5,21,26
World Cup Qualifying - Group Four 2009/10,Russia,10,7,1,2,19,6,13,22
World Cup Qualifying - Group Four 2009/10,Finland,10,5,3,2,14,14,0,18
World Cup Qualifying - Group Four 2009/10,Wales,10,4,0,6,9,12,-3,12
World Cup Qualifying - Group Four 2009/10,Azerbaijan,10,1,2,7,4,14,-10,5
World Cup Qualifying - Group Four 2009/10,Liechtenstein,10,0,2,8,2,23,-21,2
World Cup Qualifying - Group One 2009/10,Denmark,10,6,3,1,16,5,11,21
World Cup Qualifying - Group One 2009/10,Portugal,10,5,4,1,17,5,12,19
World Cup Qualifying - Group One 2009/10,Sweden,10,5,3,2,13,5,8,18
World Cup Qualifying - Group One 2009/10,Hungary,10,5,1,4,10,8,2,16
World Cup Qualifying - Group One 2009/10,Albania,10,1,4,5,6,13,-7,7
World Cup Qualifying - Group One 2009/10,Malta,10,0,1,9,0,26,-26,1
World Cup Qualifying - Group Seven 2009/10,Serbia,10,7,1,2,22,8,14,22
World Cup Qualifying - Group Seven 2009/10,France,10,6,3,1,18,9,9,21
World Cup Qualifying - Group Seven 2009/10,Austria,10,4,2,4,14,15,-1,14
World Cup Qualifying - Group Seven 2009/10,Lithuania,10,4,0,6,10,11,-1,12
World Cup Qualifying - Group Seven 2009/10,Romania,10,3,3,4,12,18,-6,12
World Cup Qualifying - Group Seven 2009/10,Faroe Islands,10,1,1,8,5,20,-15,4
World Cup Qualifying - Group Six 2009/10,England,10,9,0,1,34,6,28,27
World Cup Qualifying - Group Six 2009/10,Ukraine,10,6,3,1,21,6,15,21
World Cup Qualifying - Group Six 2009/10,Croatia,10,6,2,2,19,13,6,20
World Cup Qualifying - Group Six 2009/10,Belarus,10,4,1,5,19,14,5,13
World Cup Qualifying - Group Six 2009/10,Kazakhstan,10,2,0,8,11,29,-18,6
World Cup Qualifying - Group Six 2009/10,Andorra,10,0,0,10,3,39,-36,0
World Cup Qualifying - Group Three 2009/10,Slovakia,10,7,1,2,22,10,12,22
World Cup Qualifying - Group Three 2009/10,Slovenia,10,6,2,2,18,4,14,20
World Cup Qualifying - Group Three 2009/10,Czech Republic,10,4,4,2,17,6,11,16
World Cup Qualifying - Group Three 2009/10,Northern Ireland,10,4,3,3,13,9,4,15
World Cup Qualifying - Group Three 2009/10,Poland,10,3,2,5,19,14,5,11
World Cup Qualifying - Group Three 2009/10,San Marino,10,0,0,10,1,47,-46,0
World Cup Qualifying - Group Two 2009/10,Switzerland,10,6,3,1,18,8,10,21
World Cup Qualifying - Group Two 2009/10,Greece,10,6,2,2,20,10,10,20
World Cup Qualifying - Group Two 2009/10,Latvia,10,5,2,3,18,15,3,17
World Cup Qualifying - Group Two 2009/10,Israel,10,4,4,2,20,10,10,16
World Cup Qualifying - Group Two 2009/10,Luxembourg,10,1,2,7,4,25,-21,5
World Cup Qualifying - Group Two 2009/10,Moldova,10,0,3,7,6,18,-12,3
FIFA World Cup European Qualifying - Group Eight 2011/12,England,0,0,0,0,0,0,0,0
FIFA World Cup European Qualifying - Group Eight 2011/12,Moldova,0,0,0,0,0,0,0,0
FIFA World Cup European Qualifying - Group Eight 2011/12,Montenegro,0,0,0,0,0,0,0,0
FIFA World Cup European Qualifying - Group Eight 2011/12,Poland,0,0,0,0,0,0,0,0
FIFA World Cup European Qualifying - Group Eight 2011/12,San Marino,0,0,0,0,0,0,0,0
FIFA World Cup European Qualifying - Group Eight 2011/12,Ukraine,0,0,0,0,0,0,0,0
FIFA World Cup European Qualifying - Group Five 2011/12,Albania,0,0,0,0,0,0,0,0
FIFA World Cup European Qualifying - Group Five 2011/12,Cyprus,0,0,0,0,0,0,0,0
FIFA World Cup European Qualifying - Group Five 2011/12,Iceland,0,0,0,0,0,0,0,0
FIFA World Cup European Qualifying - Group Five 2011/12,Norway,0,0,0,0,0,0,0,0
FIFA World Cup European Qualifying - Group Five 2011/12,Slovenia,0,0,0,0,0,0,0,0
FIFA World Cup European Qualifying - Group Five 2011/12,Switzerland,0,0,0,0,0,0,0,0
FIFA World Cup European Qualifying - Group Four 2011/12,Andorra,0,0,0,0,0,0,0,0
FIFA World Cup European Qualifying - Group Four 2011/12,Estonia,0,0,0,0,0,0,0,0
FIFA World Cup European Qualifying - Group Four 2011/12,Netherlands,0,0,0,0,0,0,0,0
FIFA World Cup European Qualifying - Group Four 2011/12,Hungary,0,0,0,0,0,0,0,0
FIFA World Cup European Qualifying - Group Four 2011/12,Romania,0,0,0,0,0,0,0,0
FIFA World Cup European Qualifying - Group Four 2011/12,Turkey,0,0,0,0,0,0,0,0
FIFA World Cup European Qualifying - Group Nine 2011/12,Belarus,0,0,0,0,0,0,0,0
FIFA World Cup European Qualifying - Group Nine 2011/12,Finland,0,0,0,0,0,0,0,0
FIFA World Cup European Qualifying - Group Nine 2011/12,France,0,0,0,0,0,0,0,0
FIFA World Cup European Qualifying - Group Nine 2011/12,Georgia,0,0,0,0,0,0,0,0
FIFA World Cup European Qualifying - Group Nine 2011/12,Spain,0,0,0,0,0,0,0,0
FIFA World Cup European Qualifying - Group One 2011/12,Belgium,0,0,0,0,0,0,0,0
FIFA World Cup European Qualifying - Group One 2011/12,Croatia,0,0,0,0,0,0,0,0
FIFA World Cup European Qualifying - Group One 2011/12,North Macedonia,0,0,0,0,0,0,0,0
FIFA World Cup European Qualifying - Group One 2011/12,Scotland,0,0,0,0,0,0,0,0
FIFA World Cup European Qualifying - Group One 2011/12,Serbia,0,0,0,0,0,0,0,0
FIFA World Cup European Qualifying - Group One 2011/12,Wales,0,0,0,0,0,0,0,0
FIFA World Cup European Qualifying - Group Seven 2011/12,Bosnia and Herzegovina,0,0,0,0,0,0,0,0
FIFA World Cup European Qualifying - Group Seven 2011/12,Greece,0,0,0,0,0,0,0,0
FIFA World Cup European Qualifying - Group Seven 2011/12,Latvia,0,0,0,0,0,0,0,0
FIFA World Cup European Qualifying - Group Seven 2011/12,Liechtenstein,0,0,0,0,0,0,0,0
FIFA World Cup European Qualifying - Group Seven 2011/12,Lithuania,0,0,0,0,0,0,0,0
FIFA World Cup European Qualifying - Group Seven 2011/12,Slovakia,0,0,0,0,0,0,0,0
FIFA World Cup European Qualifying - Group Six 2011/12,Azerbaijan,0,0,0,0,0,0,0,0
FIFA World Cup European Qualifying - Group Six 2011/12,Israel,0,0,0,0,0,0,0,0
FIFA World Cup European Qualifying - Group Six 2011/12,Luxembourg,0,0,0,0,0,0,0,0
FIFA World Cup European Qualifying - Group Six 2011/12,Northern Ireland,0,0,0,0,0,0,0,0
FIFA World Cup European Qualifying - Group Six 2011/12,Portugal,0,0,0,0,0,0,0,0
FIFA World Cup European Qualifying - Group Six 2011/12,Russia,0,0,0,0,0,0,0,0
FIFA World Cup European Qualifying - Group Three 2011/12,Austria,0,0,0,0,0,0,0,0
FIFA World Cup European Qualifying - Group Three 2011/12,Faroe Islands,0,0,0,0,0,0,0,0
FIFA World Cup European Qualifying - Group Three 2011/12,Germany,0,0,0,0,0,0,0,0
FIFA World Cup European Qualifying - Group Three 2011/12,Kazakhstan,0,0,0,0,0,0,0,0
FIFA World Cup European Qualifying - Group Three 2011/12,Republic of Ireland,0,0,0,0,0,0,0,0
FIFA World Cup European Qualifying - Group Three 2011/12,Sweden,0,0,0,0,0,0,0,0
FIFA World Cup European Qualifying - Group Two 2011/12,Armenia,0,0,0,0,0,0,0,0
FIFA World Cup European Qualifying - Group Two 2011/12,Bulgaria,0,0,0,0,0,0,0,0
FIFA World Cup European Qualifying - Group Two 2011/12,Czech Republic,0,0,0,0,0,0,0,0
FIFA World Cup European Qualifying - Group Two 2011/12,Denmark,0,0,0,0,0,0,0,0
FIFA World Cup European Qualifying - Group Two 2011/12,Italy,0,0,0,0,0,0,0,0
FIFA World Cup European Qualifying - Group Two 2011/12,Malta,0,0,0,0,0,0,0,0
FIFA World Cup European Qualifying - Group A 2012/13,Belgium,7,6,1,0,13,2,11,19
FIFA World Cup European Qualifying - Group A 2012/13,Croatia,7,5,1,1,10,4,6,16
FIFA World Cup European Qualifying - Group A 2012/13,Serbia,7,2,1,4,9,9,0,7
FIFA World Cup European Qualifying - Group A 2012/13,Wales,6,2,0,4,6,14,-8,6
FIFA World Cup European Qualifying - Group A 2012/13,Scotland,7,1,2,4,4,9,-5,5
FIFA World Cup European Qualifying - Group A 2012/13,North Macedonia,6,1,1,4,3,7,-4,4
FIFA World Cup European Qualifying - Group F 2012/13,Portugal,7,4,2,1,12,6,6,14
FIFA World Cup European Qualifying - Group F 2012/13,Russia,5,4,0,1,8,1,7,12
FIFA World Cup European Qualifying - Group F 2012/13,Israel,6,3,2,1,15,8,7,11
FIFA World Cup European Qualifying - Group F 2012/13,Azerbaijan,7,0,4,3,3,9,-6,4
FIFA World Cup European Qualifying - Group F 2012/13,Northern Ireland,5,0,3,2,3,7,-4,3
FIFA World Cup European Qualifying - Group F 2012/13,Luxembourg,6,0,3,3,3,13,-10,3
FIFA World Cup European Qualifying - Group H 2012/13,Montenegro,7,4,2,1,14,7,7,14
FIFA World Cup European Qualifying - Group H 2012/13,England,6,3,3,0,21,3,18,12
FIFA World Cup European Qualifying - Group H 2012/13,Ukraine,6,3,2,1,10,4,6,11
FIFA World Cup European Qualifying - Group H 2012/13,Poland,6,2,3,1,12,7,5,9
FIFA World Cup European Qualifying - Group H 2012/13,Moldova,7,1,2,4,4,11,-7,5
FIFA World Cup European Qualifying - Group H 2012/13,San Marino,6,0,0,6,0,29,-29,0
FIFA World Cup European Qualifying - Group A 2013/14,Belgium,10,8,2,0,18,4,14,26
FIFA World Cup European Qualifying - Group A 2013/14,Croatia,10,5,2,3,12,9,3,17
FIFA World Cup European Qualifying - Group A 2013/14,Serbia,10,4,2,4,18,11,7,14
FIFA World Cup European Qualifying - Group A 2013/14,Scotland,10,3,2,5,8,12,-4,11
FIFA World Cup European Qualifying - Group A 2013/14,Wales,10,3,1,6,9,20,-11,10
FIFA World Cup European Qualifying - Group A 2013/14,North Macedonia,10,2,1,7,7,16,-9,7
FIFA World Cup European Qualifying - Group B 2013/14,Italy,10,6,4,0,19,9,10,22
FIFA World Cup European Qualifying - Group B 2013/14,Denmark,10,4,4,2,17,12,5,16
FIFA World Cup European Qualifying - Group B 2013/14,Czech Republic,10,4,3,3,13,9,4,15
FIFA World Cup European Qualifying - Group B 2013/14,Bulgaria,10,3,4,3,14,9,5,13
FIFA World Cup European Qualifying - Group B 2013/14,Armenia,10,4,1,5,12,13,-1,13
FIFA World Cup European Qualifying - Group B 2013/14,Malta,10,1,0,9,5,28,-23,3
FIFA World Cup European Qualifying - Group C 2013/14,Germany,10,9,1,0,36,10,26,28
FIFA World Cup European Qualifying - Group C 2013/14,Sweden,10,6,2,2,19,14,5,20
FIFA World Cup European Qualifying - Group C 2013/14,Austria,10,5,2,3,20,10,10,17
FIFA World Cup European Qualifying - Group C 2013/14,Republic of Ireland,10,4,2,4,16,17,-1,14
FIFA World Cup European Qualifying - Group C 2013/14,Kazakhstan,10,1,2,7,6,21,-15,5
FIFA World Cup European Qualifying - Group C 2013/14,Faroe Islands,10,0,1,9,4,29,-25,1
FIFA World Cup European Qualifying - Group D 2013/14,Netherlands,10,9,1,0,34,5,29,28
FIFA World Cup European Qualifying - Group D 2013/14,Romania,10,6,1,3,19,12,7,19
FIFA World Cup European Qualifying - Group D 2013/14,Hungary,10,5,2,3,21,20,1,17
FIFA World Cup European Qualifying - Group D 2013/14,Turkey,10,5,1,4,16,9,7,16
FIFA World Cup European Qualifying - Group D 2013/14,Estonia,10,2,1,7,6,20,-14,7
FIFA World Cup European Qualifying - Group D 2013/14,Andorra,10,0,0,10,0,30,-30,0
FIFA World Cup European Qualifying - Group E 2013/14,Switzerland,10,7,3,0,17,6,11,24
FIFA World Cup European Qualifying - Group E 2013/14,Iceland,10,5,2,3,17,15,2,17
FIFA World Cup European Qualifying - Group E 2013/14,Slovenia,10,5,0,5,14,11,3,15
FIFA World Cup European Qualifying - Group E 2013/14,Norway,10,3,3,4,10,13,-3,12
FIFA World Cup European Qualifying - Group E 2013/14,Albania,10,3,2,5,9,11,-2,11
FIFA World Cup European Qualifying - Group E 2013/14,Cyprus,10,1,2,7,4,15,-11,5
FIFA World Cup European Qualifying - Group F 2013/14,Russia,10,7,1,2,20,5,15,22
FIFA World Cup European Qualifying - Group F 2013/14,Portugal,10,6,3,1,20,9,11,21
FIFA World Cup European Qualifying - Group F 2013/14,Israel,10,3,5,2,19,14,5,14
FIFA World Cup European Qualifying - Group F 2013/14,Azerbaijan,10,1,6,3,7,11,-4,9
FIFA World Cup European Qualifying - Group F 2013/14,Northern Ireland,10,1,4,5,9,17,-8,7
FIFA World Cup European Qualifying - Group F 2013/14,Luxembourg,10,1,3,6,7,26,-19,6
FIFA World Cup European Qualifying - Group G 2013/14,Bosnia and Herzegovina,10,8,1,1,30,6,24,25
FIFA World Cup European Qualifying - Group G 2013/14,Greece,10,8,1,1,12,4,8,25
FIFA World Cup European Qualifying - Group G 2013/14,Slovakia,10,3,4,3,11,10,1,13
FIFA World Cup European Qualifying - Group G 2013/14,Lithuania,10,3,2,5,9,11,-2,11
FIFA World Cup European Qualifying - Group G 2013/14,Latvia,10,2,2,6,10,20,-10,8
FIFA World Cup European Qualifying - Group G 2013/14,Liechtenstein,10,0,2,8,4,25,-21,2
FIFA World Cup European Qualifying - Group H 2013/14,England,10,6,4,0,31,4,27,22
FIFA World Cup European Qualifying - Group H 2013/14,Ukraine,10,6,3,1,28,4,24,21
FIFA World Cup European Qualifying - Group H 2013/14,Montenegro,10,4,3,3,18,17,1,15
FIFA World Cup European Qualifying - Group H 2013/14,Poland,10,3,4,3,18,12,6,13
FIFA World Cup European Qualifying - Group H 2013/14,Moldova,10,3,2,5,12,17,-5,11
FIFA World Cup European Qualifying - Group H 2013/14,San Marino,10,0,0,10,1,54,-53,0
FIFA World Cup European Qualifying - Group A 2015/16,Belarus,0,0,0,0,0,0,0,0
FIFA World Cup European Qualifying - Group A 2015/16,Bulgaria,0,0,0,0,0,0,0,0
FIFA World Cup European Qualifying - Group A 2015/16,France,0,0,0,0,0,0,0,0
FIFA World Cup European Qualifying - Group A 2015/16,Luxembourg,0,0,0,0,0,0,0,0
FIFA World Cup European Qualifying - Group A 2015/16,Netherlands,0,0,0,0,0,0,0,0
FIFA World Cup European Qualifying - Group A 2015/16,Sweden,0,0,0,0,0,0,0,0
FIFA World Cup European Qualifying - Group B 2015/16,Andorra,0,0,0,0,0,0,0,0
FIFA World Cup European Qualifying - Group B 2015/16,Faroe Islands,0,0,0,0,0,0,0,0
FIFA World Cup European Qualifying - Group B 2015/16,Hungary,0,0,0,0,0,0,0,0
FIFA World Cup European Qualifying - Group B 2015/16,Latvia,0,0,0,0,0,0,0,0
FIFA World Cup European Qualifying - Group B 2015/16,Portugal,0,0,0,0,0,0,0,0
FIFA World Cup European Qualifying - Group B 2015/16,Switzerland,0,0,0,0,0,0,0,0
FIFA World Cup European Qualifying - Group C 2015/16,Azerbaijan,0,0,0,0,0,0,0,0
FIFA World Cup European Qualifying - Group C 2015/16,Czech Republic,0,0,0,0,0,0,0,0
FIFA World Cup European Qualifying - Group C 2015/16,Germany,0,0,0,0,0,0,0,0
FIFA World Cup European Qualifying - Group C 2015/16,Northern Ireland,0,0,0,0,0,0,0,0
FIFA World Cup European Qualifying - Group C 2015/16,Norway,0,0,0,0,0,0,0,0
FIFA World Cup European Qualifying - Group C 2015/16,San Marino,0,0,0,0,0,0,0,0
FIFA World Cup European Qualifying - Group D 2015/16,Austria,0,0,0,0,0,0,0,0
FIFA World Cup European Qualifying - Group D 2015/16,Georgia,0,0,0,0,0,0,0,0
FIFA World Cup European Qualifying - Group D 2015/16,Moldova,0,0,0,0,0,0,0,0
FIFA World Cup European Qualifying - Group D 2015/16,Republic of Ireland,0,0,0,0,0,0,0,0
FIFA World Cup European Qualifying - Group D 2015/16,Serbia,0,0,0,0,0,0,0,0
FIFA World Cup European Qualifying - Group D 2015/16,Wales,0,0,0,0,0,0,0,0
FIFA World Cup European Qualifying - Group E 2015/16,Armenia,0,0,0,0,0,0,0,0
FIFA World Cup European Qualifying - Group E 2015/16,Denmark,0,0,0,0,0,0,0,0
FIFA World Cup European Qualifying - Group E 2015/16,Kazakhstan,0,0,0,0,0,0,0,0
FIFA World Cup European Qualifying - Group E 2015/16,Montenegro,0,0,0,0,0,0,0,0
FIFA World Cup European Qualifying - Group E 2015/16,Poland,0,0,0,0,0,0,0,0
FIFA World Cup European Qualifying - Group E 2015/16,Romania,0,0,0,0,0,0,0,0
FIFA World Cup European Qualifying - Group F 2015/16,England,0,0,0,0,0,0,0,0
FIFA World Cup European Qualifying - Group F 2015/16,Lithuania,0,0,0,0,0,0,0,0
FIFA World Cup European Qualifying - Group F 2015/16,Malta,0,0,0,0,0,0,0,0
FIFA World Cup European Qualifying - Group F 2015/16,Scotland,0,0,0,0,0,0,0,0
FIFA World Cup European Qualifying - Group F 2015/16,Slovakia,0,0,0,0,0,0,0,0
FIFA World Cup European Qualifying - Group F 2015/16,Slovenia,0,0,0,0,0,0,0,0
FIFA World Cup European Qualifying - Group G 2015/16,Albania,0,0,0,0,0,0,0,0
FIFA World Cup European Qualifying - Group G 2015/16,Israel,0,0,0,0,0,0,0,0
FIFA World Cup European Qualifying - Group G 2015/16,Italy,0,0,0,0,0,0,0,0
FIFA World Cup European Qualifying - Group G 2015/16,Liechtenstein,0,0,0,0,0,0,0,0
FIFA World Cup European Qualifying - Group G 2015/16,North Macedonia,0,0,0,0,0,0,0,0
FIFA World Cup European Qualifying - Group G 2015/16,Spain,0,0,0,0,0,0,0,0
FIFA World Cup European Qualifying - Group H 2015/16,Belgium,0,0,0,0,0,0,0,0
FIFA World Cup European Qualifying - Group H 2015/16,Bosnia and Herzegovina,0,0,0,0,0,0,0,0
FIFA World Cup European Qualifying - Group H 2015/16,Cyprus,0,0,0,0,0,0,0,0
FIFA World Cup European Qualifying - Group H 2015/16,Estonia,0,0,0,0,0,0,0,0
FIFA World Cup European Qualifying - Group H 2015/16,Greece,0,0,0,0,0,0,0,0
FIFA World Cup European Qualifying - Group I 2015/16,Croatia,0,0,0,0,0,0,0,0
FIFA World Cup European Qualifying - Group I 2015/16,Finland,0,0,0,0,0,0,0,0
FIFA World Cup European Qualifying - Group I 2015/16,Iceland,0,0,0,0,0,0,0,0
FIFA World Cup European Qualifying - Group I 2015/16,Turkey,0,0,0,0,0,0,0,0
FIFA World Cup European Qualifying - Group I 2015/16,Ukraine,0,0,0,0,0,0,0,0
FIFA World Cup CONCACAF Qualifying - 1st Round 2015/16,Trinidad and Tobago,4,3,1,0,11,3,8,10
FIFA World Cup CONCACAF Qualifying - 1st Round 2015/16,United States of America,4,2,1,1,10,3,7,7
FIFA World Cup CONCACAF Qualifying - 1st Round 2015/16,Guatemala,4,2,0,2,7,6,1,6
FIFA World Cup CONCACAF Qualifying - 1st Round 2015/16,St. Vincent and the Grenadines,4,0,0,4,3,19,-16,0
FIFA World Cup South American  - Qualifying Tournament 2015/16,Uruguay,6,4,1,1,12,4,8,13
FIFA World Cup South American  - Qualifying Tournament 2015/16,Ecuador,6,4,1,1,12,7,5,13
FIFA World Cup South American  - Qualifying Tournament 2015/16,Argentina,6,3,2,1,6,4,2,11
FIFA World Cup South American  - Qualifying Tournament 2015/16,Chile,6,3,1,2,12,10,2,10
FIFA World Cup South American  - Qualifying Tournament 2015/16,Colombia,6,3,1,2,9,8,1,10
FIFA World Cup South American  - Qualifying Tournament 2015/16,Brazil,6,2,3,1,11,8,3,9
FIFA World Cup South American  - Qualifying Tournament 2015/16,Paraguay,6,2,3,1,7,6,1,9
FIFA World Cup South American  - Qualifying Tournament 2015/16,Peru,6,1,1,4,6,12,-6,4
FIFA World Cup South American  - Qualifying Tournament 2015/16,Bolivia,6,1,0,5,7,13,-6,3
FIFA World Cup South American  - Qualifying Tournament 2015/16,Venezuela,6,0,1,5,7,17,-10,1
FIFA World Cup European Qualifying - Group A 2016/17,Sweden,6,4,1,1,12,4,8,13
FIFA World Cup European Qualifying - Group A 2016/17,France,6,4,1,1,11,5,6,13
FIFA World Cup European Qualifying - Group A 2016/17,Netherlands,6,3,1,2,13,6,7,10
FIFA World Cup European Qualifying - Group A 2016/17,Bulgaria,6,3,0,3,9,12,-3,9
FIFA World Cup European Qualifying - Group A 2016/17,Belarus,6,1,2,3,4,11,-7,5
FIFA World Cup European Qualifying - Group A 2016/17,Luxembourg,6,0,1,5,6,17,-11,1
FIFA World Cup European Qualifying - Group B 2016/17,Switzerland,6,6,0,0,12,3,9,18
FIFA World Cup European Qualifying - Group B 2016/17,Portugal,6,5,0,1,22,3,19,15
FIFA World Cup European Qualifying - Group B 2016/17,Hungary,6,2,1,3,8,7,1,7
FIFA World Cup European Qualifying - Group B 2016/17,Faroe Islands,6,1,2,3,2,10,-8,5
FIFA World Cup European Qualifying - Group B 2016/17,Andorra,6,1,1,4,2,13,-11,4
FIFA World Cup European Qualifying - Group B 2016/17,Latvia,6,1,0,5,2,12,-10,3
FIFA World Cup European Qualifying - Group C 2016/17,Germany,6,6,0,0,27,1,26,18
FIFA World Cup European Qualifying - Group C 2016/17,Northern Ireland,6,4,1,1,11,2,9,13
FIFA World Cup European Qualifying - Group C 2016/17,Czech Republic,6,2,3,1,9,5,4,9
FIFA World Cup European Qualifying - Group C 2016/17,Azerbaijan,6,2,1,3,3,9,-6,7
FIFA World Cup European Qualifying - Group C 2016/17,Norway,6,1,1,4,6,10,-4,4
FIFA World Cup European Qualifying - Group C 2016/17,San Marino,6,0,0,6,1,30,-29,0
FIFA World Cup European Qualifying - Group D 2016/17,Serbia,6,3,3,0,13,7,6,12
FIFA World Cup European Qualifying - Group D 2016/17,Republic of Ireland,6,3,3,0,8,4,4,12
FIFA World Cup European Qualifying - Group D 2016/17,Wales,6,1,5,0,9,5,4,8
FIFA World Cup European Qualifying - Group D 2016/17,Austria,6,2,2,2,9,8,1,8
FIFA World Cup European Qualifying - Group D 2016/17,Georgia,6,0,3,3,6,10,-4,3
FIFA World Cup European Qualifying - Group D 2016/17,Moldova,6,0,2,4,4,15,-11,2
FIFA World Cup European Qualifying - Group E 2016/17,Poland,6,5,1,0,15,7,8,16
FIFA World Cup European Qualifying - Group E 2016/17,Montenegro,6,3,1,2,14,7,7,10
FIFA World Cup European Qualifying - Group E 2016/17,Denmark,6,3,1,2,10,6,4,10
FIFA World Cup European Qualifying - Group E 2016/17,Romania,6,1,3,2,7,7,0,6
FIFA World Cup European Qualifying - Group E 2016/17,Armenia,6,2,0,4,7,14,-7,6
FIFA World Cup European Qualifying - Group E 2016/17,Kazakhstan,6,0,2,4,4,16,-12,2
FIFA World Cup European Qualifying - Group F 2016/17,England,6,4,2,0,10,2,8,14
FIFA World Cup European Qualifying - Group F 2016/17,Slovakia,6,4,0,2,12,4,8,12
FIFA World Cup European Qualifying - Group F 2016/17,Slovenia,6,3,2,1,6,3,3,11
FIFA World Cup European Qualifying - Group F 2016/17,Scotland,6,2,2,2,9,10,-1,8
FIFA World Cup European Qualifying - Group F 2016/17,Lithuania,6,1,2,3,6,11,-5,5
FIFA World Cup European Qualifying - Group F 2016/17,Malta,6,0,0,6,2,15,-13,0
FIFA World Cup European Qualifying - Group G 2016/17,Spain,6,5,1,0,21,3,18,16
FIFA World Cup European Qualifying - Group G 2016/17,Italy,6,5,1,0,18,4,14,16
FIFA World Cup European Qualifying - Group G 2016/17,Albania,6,3,0,3,7,8,-1,9
FIFA World Cup European Qualifying - Group G 2016/17,Israel,6,3,0,3,9,12,-3,9
FIFA World Cup European Qualifying - Group G 2016/17,North Macedonia,6,1,0,5,8,13,-5,3
FIFA World Cup European Qualifying - Group G 2016/17,Liechtenstein,6,0,0,6,1,24,-23,0
FIFA World Cup European Qualifying - Group H 2016/17,Belgium,6,5,1,0,24,2,22,16
FIFA World Cup European Qualifying - Group H 2016/17,Greece,6,3,3,0,10,3,7,12
FIFA World Cup European Qualifying - Group H 2016/17,Bosnia and Herzegovina,6,3,2,1,13,5,8,11
FIFA World Cup European Qualifying - Group H 2016/17,Cyprus,6,2,1,3,5,9,-4,7
FIFA World Cup European Qualifying - Group H 2016/17,Estonia,6,1,1,4,5,17,-12,4
FIFA World Cup European Qualifying - Group H 2016/17,Gibraltar,6,0,0,6,3,24,-21,0
FIFA World Cup European Qualifying - Group I 2016/17,Croatia,6,4,1,1,11,2,9,13
FIFA World Cup European Qualifying - Group I 2016/17,Iceland,6,4,1,1,9,6,3,13
FIFA World Cup European Qualifying - Group I 2016/17,Turkey,6,3,2,1,11,6,5,11
FIFA World Cup European Qualifying - Group I 2016/17,Ukraine,6,3,2,1,9,5,4,11
FIFA World Cup European Qualifying - Group I 2016/17,Finland,6,0,1,5,4,10,-6,1
FIFA World Cup European Qualifying - Group I 2016/17,Kosovo,6,0,1,5,3,18,-15,1
FIFA World Cup CONCACAF Qualifying - 1st Round 2016/17,Mexico,6,4,2,0,9,2,7,14
FIFA World Cup CONCACAF Qualifying - 1st Round 2016/17,Costa Rica,5,2,2,1,7,3,4,8
FIFA World Cup CONCACAF Qualifying - 1st Round 2016/17,United States of America,6,2,2,2,11,8,3,8
FIFA World Cup CONCACAF Qualifying - 1st Round 2016/17,Panama,5,1,3,1,2,2,0,6
FIFA World Cup CONCACAF Qualifying - 1st Round 2016/17,Honduras,5,1,1,3,4,12,-8,4
FIFA World Cup CONCACAF Qualifying - 1st Round 2016/17,Trinidad and Tobago,5,1,0,4,2,8,-6,3
FIFA World Cup African Qualifying - First Round 2016/17,Egypt,2,2,0,0,4,1,3,6
FIFA World Cup African Qualifying - First Round 2016/17,Uganda,2,1,1,0,1,0,1,4
FIFA World Cup African Qualifying - First Round 2016/17,Ghana,2,0,1,1,0,2,-2,1
FIFA World Cup African Qualifying - First Round 2016/17,Congo,2,0,0,2,1,3,-2,0
FIFA World Cup Oceania Qualifying - Group One 2016/17,Tahiti,4,2,0,2,5,4,1,6
FIFA World Cup Oceania Qualifying - Group One 2016/17,Solomon Islands,3,2,0,1,4,3,1,6
FIFA World Cup Oceania Qualifying - Group One 2016/17,Papua New Guinea,3,1,0,2,5,7,-2,3
FIFA World Cup South American  - Qualifying Tournament 2016/17,Brazil,14,10,3,1,35,10,25,33
FIFA World Cup South American  - Qualifying Tournament 2016/17,Colombia,14,7,3,4,18,15,3,24
FIFA World Cup South American  - Qualifying Tournament 2016/17,Uruguay,14,7,2,5,26,17,9,23
FIFA World Cup South American  - Qualifying Tournament 2016/17,Chile,14,7,2,5,24,19,5,23
FIFA World Cup South American  - Qualifying Tournament 2016/17,Argentina,14,6,4,4,15,14,1,22
FIFA World Cup South American  - Qualifying Tournament 2016/17,Ecuador,14,6,2,6,23,20,3,20
FIFA World Cup South American  - Qualifying Tournament 2016/17,Peru,14,5,3,6,22,23,-1,18
FIFA World Cup South American  - Qualifying Tournament 2016/17,Paraguay,14,5,3,6,13,21,-8,18
FIFA World Cup South American  - Qualifying Tournament 2016/17,Bolivia,14,3,1,10,12,32,-20,10
FIFA World Cup South American  - Qualifying Tournament 2016/17,Venezuela,14,1,3,10,17,34,-17,6
FIFA World Cup Asian Qualifying - Group One 2016/17,Japan,7,5,1,1,14,5,9,16
FIFA World Cup Asian Qualifying - Group One 2016/17,Saudi Arabia,8,5,1,2,15,8,7,16
FIFA World Cup Asian Qualifying - Group One 2016/17,Australia,8,4,4,0,14,8,6,16
FIFA World Cup Asian Qualifying - Group One 2016/17,U.A.E,7,3,0,4,7,10,-3,9
FIFA World Cup Asian Qualifying - Group One 2016/17,Iraq,7,1,1,5,7,10,-3,4
FIFA World Cup Asian Qualifying - Group One 2016/17,Thailand,7,0,1,6,3,19,-16,1
FIFA World Cup European Qualifying - Group A 2017/18,France,10,7,2,1,18,6,12,23
FIFA World Cup European Qualifying - Group A 2017/18,Sweden,10,6,1,3,26,9,17,19
FIFA World Cup European Qualifying - Group A 2017/18,Netherlands,10,6,1,3,21,12,9,19
FIFA World Cup European Qualifying - Group A 2017/18,Bulgaria,10,4,1,5,14,19,-5,13
FIFA World Cup European Qualifying - Group A 2017/18,Luxembourg,10,1,3,6,8,26,-18,6
FIFA World Cup European Qualifying - Group A 2017/18,Belarus,10,1,2,7,6,21,-15,5
FIFA World Cup European Qualifying - Group B 2017/18,Portugal,10,9,0,1,32,4,28,27
FIFA World Cup European Qualifying - Group B 2017/18,Switzerland,10,9,0,1,23,7,16,27
FIFA World Cup European Qualifying - Group B 2017/18,Hungary,10,4,1,5,14,14,0,13
FIFA World Cup European Qualifying - Group B 2017/18,Faroe Islands,10,2,3,5,4,16,-12,9
FIFA World Cup European Qualifying - Group B 2017/18,Latvia,10,2,1,7,7,18,-11,7
FIFA World Cup European Qualifying - Group B 2017/18,Andorra,10,1,1,8,2,23,-21,4
FIFA World Cup European Qualifying - Group C 2017/18,Germany,10,10,0,0,43,4,39,30
FIFA World Cup European Qualifying - Group C 2017/18,Northern Ireland,10,6,1,3,17,6,11,19
FIFA World Cup European Qualifying - Group C 2017/18,Czech Republic,10,4,3,3,17,10,7,15
FIFA World Cup European Qualifying - Group C 2017/18,Norway,10,4,1,5,17,16,1,13
FIFA World Cup European Qualifying - Group C 2017/18,Azerbaijan,10,3,1,6,10,19,-9,10
FIFA World Cup European Qualifying - Group C 2017/18,San Marino,10,0,0,10,2,51,-49,0
FIFA World Cup European Qualifying - Group D 2017/18,Serbia,10,6,3,1,20,10,10,21
FIFA World Cup European Qualifying - Group D 2017/18,Republic of Ireland,10,5,4,1,12,6,6,19
FIFA World Cup European Qualifying - Group D 2017/18,Wales,10,4,5,1,13,6,7,17
FIFA World Cup European Qualifying - Group D 2017/18,Austria,10,4,3,3,14,12,2,15
FIFA World Cup European Qualifying - Group D 2017/18,Georgia,10,0,5,5,8,14,-6,5
FIFA World Cup European Qualifying - Group D 2017/18,Moldova,10,0,2,8,4,23,-19,2
FIFA World Cup European Qualifying - Group E 2017/18,Poland,10,8,1,1,28,14,14,25
FIFA World Cup European Qualifying - Group E 2017/18,Denmark,10,6,2,2,20,8,12,20
FIFA World Cup European Qualifying - Group E 2017/18,Montenegro,10,5,1,4,20,12,8,16
FIFA World Cup European Qualifying - Group E 2017/18,Romania,10,3,4,3,12,10,2,13
FIFA World Cup European Qualifying - Group E 2017/18,Armenia,10,2,1,7,10,26,-16,7
FIFA World Cup European Qualifying - Group E 2017/18,Kazakhstan,10,0,3,7,6,26,-20,3
FIFA World Cup European Qualifying - Group F 2017/18,England,10,8,2,0,18,3,15,26
FIFA World Cup European Qualifying - Group F 2017/18,Slovakia,10,6,0,4,17,7,10,18
FIFA World Cup European Qualifying - Group F 2017/18,Scotland,10,5,3,2,17,12,5,18
FIFA World Cup European Qualifying - Group F 2017/18,Slovenia,10,4,3,3,12,7,5,15
FIFA World Cup European Qualifying - Group F 2017/18,Lithuania,10,1,3,6,7,20,-13,6
FIFA World Cup European Qualifying - Group F 2017/18,Malta,10,0,1,9,3,25,-22,1
FIFA World Cup European Qualifying - Group G 2017/18,Spain,10,9,1,0,36,3,33,28
FIFA World Cup European Qualifying - Group G 2017/18,Italy,10,7,2,1,21,8,13,23
FIFA World Cup European Qualifying - Group G 2017/18,Albania,10,4,1,5,10,13,-3,13
FIFA World Cup European Qualifying - Group G 2017/18,Israel,10,4,0,6,10,15,-5,12
FIFA World Cup European Qualifying - Group G 2017/18,North Macedonia,10,3,2,5,15,15,0,11
FIFA World Cup European Qualifying - Group G 2017/18,Liechtenstein,10,0,0,10,1,39,-38,0
FIFA World Cup European Qualifying - Group H 2017/18,Belgium,10,9,1,0,43,6,37,28
FIFA World Cup European Qualifying - Group H 2017/18,Greece,10,5,4,1,17,6,11,19
FIFA World Cup European Qualifying - Group H 2017/18,Bosnia and Herzegovina,10,5,2,3,24,13,11,17
FIFA World Cup European Qualifying - Group H 2017/18,Estonia,10,3,2,5,13,19,-6,11
FIFA World Cup European Qualifying - Group H 2017/18,Cyprus,10,3,1,6,9,18,-9,10
FIFA World Cup European Qualifying - Group H 2017/18,Gibraltar,10,0,0,10,3,47,-44,0
FIFA World Cup European Qualifying - Group I 2017/18,Iceland,10,7,1,2,16,7,9,22
FIFA World Cup European Qualifying - Group I 2017/18,Croatia,10,6,2,2,15,4,11,20
FIFA World Cup European Qualifying - Group I 2017/18,Ukraine,10,5,2,3,13,9,4,17
FIFA World Cup European Qualifying - Group I 2017/18,Turkey,10,4,3,3,14,13,1,15
FIFA World Cup European Qualifying - Group I 2017/18,Finland,10,2,3,5,9,13,-4,9
FIFA World Cup European Qualifying - Group I 2017/18,Kosovo,10,0,1,9,3,24,-21,1
FIFA World Cup CONCACAF Qualifying - 1st Round 2017/18,Mexico,10,6,3,1,16,7,9,21
FIFA World Cup CONCACAF Qualifying - 1st Round 2017/18,Costa Rica,10,4,4,2,14,8,6,16
FIFA World Cup CONCACAF Qualifying - 1st Round 2017/18,Panama,10,3,4,3,9,10,-1,13
FIFA World Cup CONCACAF Qualifying - 1st Round 2017/18,Honduras,10,3,4,3,13,19,-6,13
FIFA World Cup CONCACAF Qualifying - 1st Round 2017/18,United States of America,10,3,3,4,17,13,4,12
FIFA World Cup CONCACAF Qualifying - 1st Round 2017/18,Trinidad and Tobago,10,2,0,8,7,19,-12,6
FIFA World Cup African Qualifying - First Round 2017/18,Egypt,6,4,1,1,8,4,4,13
FIFA World Cup African Qualifying - First Round 2017/18,Uganda,6,2,3,1,3,2,1,9
FIFA World Cup African Qualifying - First Round 2017/18,Ghana,6,1,4,1,7,5,2,7
FIFA World Cup African Qualifying - First Round 2017/18,Congo,6,0,2,4,5,12,-7,2
FIFA World Cup Oceania Qualifying - Group One 2017/18,Solomon Islands,4,3,0,1,6,4,2,9
FIFA World Cup Oceania Qualifying - Group One 2017/18,Tahiti,4,2,0,2,5,4,1,6
FIFA World Cup Oceania Qualifying - Group One 2017/18,Papua New Guinea,4,1,0,3,6,9,-3,3
FIFA World Cup South American  - Qualifying Tournament 2017/18,Brazil,18,12,5,1,41,11,30,41
FIFA World Cup South American  - Qualifying Tournament 2017/18,Uruguay,18,9,4,5,32,20,12,31
FIFA World Cup South American  - Qualifying Tournament 2017/18,Argentina,18,7,7,4,19,16,3,28
FIFA World Cup South American  - Qualifying Tournament 2017/18,Colombia,18,7,6,5,21,19,2,27
FIFA World Cup South American  - Qualifying Tournament 2017/18,Peru,18,7,5,6,27,26,1,26
FIFA World Cup South American  - Qualifying Tournament 2017/18,Chile,18,8,2,8,26,27,-1,26
FIFA World Cup South American  - Qualifying Tournament 2017/18,Paraguay,18,7,3,8,19,25,-6,24
FIFA World Cup South American  - Qualifying Tournament 2017/18,Ecuador,18,6,2,10,26,29,-3,20
FIFA World Cup South American  - Qualifying Tournament 2017/18,Bolivia,18,4,2,12,16,38,-22,14
FIFA World Cup South American  - Qualifying Tournament 2017/18,Venezuela,18,2,6,10,19,35,-16,12
FIFA World Cup Asian Qualifying - Group One 2017/18,Japan,10,6,2,2,17,7,10,20
FIFA World Cup Asian Qualifying - Group One 2017/18,Saudi Arabia,10,6,1,3,17,10,7,19
FIFA World Cup Asian Qualifying - Group One 2017/18,Australia,10,5,4,1,16,11,5,19
FIFA World Cup Asian Qualifying - Group One 2017/18,U.A.E,10,4,1,5,10,13,-3,13
FIFA World Cup Asian Qualifying - Group One 2017/18,Iraq,10,3,2,5,11,12,-1,11
FIFA World Cup Asian Qualifying - Group One 2017/18,Thailand,10,0,2,8,6,24,-18,2
FIFA World Cup CONCACAF Qualifying - 1st Round 2018/19,Mexico,10,6,3,1,16,7,9,21
FIFA World Cup CONCACAF Qualifying - 1st Round 2018/19,Costa Rica,10,4,4,2,14,8,6,16
FIFA World Cup CONCACAF Qualifying - 1st Round 2018/19,Panama,10,3,4,3,9,10,-1,13
FIFA World Cup CONCACAF Qualifying - 1st Round 2018/19,Honduras,10,3,4,3,13,19,-6,13
FIFA World Cup CONCACAF Qualifying - 1st Round 2018/19,United States of America,10,3,3,4,17,13,4,12
FIFA World Cup CONCACAF Qualifying - 1st Round 2018/19,Trinidad and Tobago,10,2,0,8,7,19,-12,6
FIFA World Cup South American  - Qualifying Tournament 2019/20,Argentina,0,0,0,0,0,0,0,0
FIFA World Cup South American  - Qualifying Tournament 2019/20,Bolivia,0,0,0,0,0,0,0,0
FIFA World Cup South American  - Qualifying Tournament 2019/20,Brazil,0,0,0,0,0,0,0,0
FIFA World Cup South American  - Qualifying Tournament 2019/20,Chile,0,0,0,0,0,0,0,0
FIFA World Cup South American  - Qualifying Tournament 2019/20,Colombia,0,0,0,0,0,0,0,0
FIFA World Cup South American  - Qualifying Tournament 2019/20,Ecuador,0,0,0,0,0,0,0,0
FIFA World Cup South American  - Qualifying Tournament 2019/20,Paraguay,0,0,0,0,0,0,0,0
FIFA World Cup South American  - Qualifying Tournament 2019/20,Peru,0,0,0,0,0,0,0,0
FIFA World Cup South American  - Qualifying Tournament 2019/20,Uruguay,0,0,0,0,0,0,0,0
FIFA World Cup South American  - Qualifying Tournament 2019/20,Venezuela,0,0,0,0,0,0,0,0
FIFA World Cup Asian Qualifying - Group One 2019/20,Turkmenistan,5,3,0,2,8,5,3,9
FIFA World Cup Asian Qualifying - Group One 2019/20,Korea Republic,4,2,2,0,10,0,10,8
FIFA World Cup Asian Qualifying - Group One 2019/20,Lebanon,5,2,2,1,5,3,2,8
FIFA World Cup Asian Qualifying - Group One 2019/20,Korea DPR,5,2,2,1,4,3,1,8
FIFA World Cup Asian Qualifying - Group One 2019/20,Sri Lanka,5,0,0,5,0,16,-16,0
Spanish Primera Liga 2009/10,Barcelona,38,31,6,1,98,24,74,99
Spanish Primera Liga 2009/10,Real Madrid,38,31,3,4,102,35,67,96
Spanish Primera Liga 2009/10,Valencia,38,21,8,9,59,40,19,71
Spanish Primera Liga 2009/10,Sevilla,38,19,6,13,65,49,16,63
Spanish Primera Liga 2009/10,Real Mallorca,38,18,8,12,59,44,15,62
Spanish Primera Liga 2009/10,Getafe,38,17,7,14,58,48,10,58
Spanish Primera Liga 2009/10,Villarreal,38,16,8,14,58,57,1,56
Spanish Primera Liga 2009/10,Athletic Bilbao,38,15,9,14,50,53,-3,54
Spanish Primera Liga 2009/10,Atletico Madrid,38,13,8,17,57,61,-4,47
Spanish Primera Liga 2009/10,Deportivo La Coruna,38,13,8,17,35,49,-14,47
Spanish Primera Liga 2009/10,Espanyol,38,11,11,16,29,46,-17,44
Spanish Primera Liga 2009/10,Osasuna,38,11,10,17,37,46,-9,43
Spanish Primera Liga 2009/10,Almeria,38,10,12,16,43,55,-12,42
Spanish Primera Liga 2009/10,Real Zaragoza,38,10,11,17,46,64,-18,41
Spanish Primera Liga 2009/10,Sporting Gijon,38,9,13,16,36,51,-15,40
Spanish Primera Liga 2009/10,Racing Santander,38,9,12,17,42,59,-17,39
Spanish Primera Liga 2009/10,Malaga,38,7,16,15,42,48,-6,37
Spanish Primera Liga 2009/10,Tenerife,38,9,9,20,40,74,-34,36
Spanish Primera Liga 2009/10,Real Valladolid,38,7,15,16,37,62,-25,36
Spanish Primera Liga 2009/10,Xerez,38,8,10,20,38,66,-28,34
Spanish Primera BBVA - 12 2010/11,Barcelona,38,30,6,2,95,21,74,96
Spanish Primera BBVA - 12 2010/11,Real Madrid,38,29,5,4,102,33,69,92
Spanish Primera BBVA - 12 2010/11,Valencia,38,21,8,9,64,44,20,71
Spanish Primera BBVA - 12 2010/11,Villarreal,38,18,8,12,54,44,10,62
Spanish Primera BBVA - 12 2010/11,Sevilla,38,17,7,14,62,61,1,58
Spanish Primera BBVA - 12 2010/11,Athletic Bilbao,38,18,4,16,59,55,4,58
Spanish Primera BBVA - 12 2010/11,Atletico Madrid,38,17,7,14,62,53,9,58
Spanish Primera BBVA - 12 2010/11,Espanyol,38,15,4,19,46,55,-9,49
Spanish Primera BBVA - 12 2010/11,Osasuna,38,13,8,17,45,46,-1,47
Spanish Primera BBVA - 12 2010/11,Sporting Gijon,38,11,14,13,35,42,-7,47
Spanish Primera BBVA - 12 2010/11,Malaga,38,13,7,18,54,68,-14,46
Spanish Primera BBVA - 12 2010/11,Racing Santander,38,12,10,16,41,56,-15,46
Spanish Primera BBVA - 12 2010/11,Real Zaragoza,38,12,9,17,40,53,-13,45
Spanish Primera BBVA - 12 2010/11,Levante,38,12,9,17,41,52,-11,45
Spanish Primera BBVA - 12 2010/11,Real Sociedad,38,14,3,21,49,66,-17,45
Spanish Primera BBVA - 12 2010/11,Getafe,38,12,8,18,49,60,-11,44
Spanish Primera BBVA - 12 2010/11,Real Mallorca,38,12,8,18,41,56,-15,44
Spanish Primera BBVA - 12 2010/11,Deportivo La Coruna,38,10,13,15,31,47,-16,43
Spanish Primera BBVA - 12 2010/11,Hercules,38,9,8,21,36,60,-24,35
Spanish Primera BBVA - 12 2010/11,Almeria,38,6,12,20,36,70,-34,30
Spanish Primera BBVA 2011/12,Real Madrid,38,32,4,2,121,32,89,100
Spanish Primera BBVA 2011/12,Barcelona,38,28,7,3,114,29,85,91
Spanish Primera BBVA 2011/12,Valencia,38,17,10,11,59,44,15,61
Spanish Primera BBVA 2011/12,Malaga,38,17,7,14,54,53,1,58
Spanish Primera BBVA 2011/12,Atletico Madrid,38,15,11,12,53,46,7,56
Spanish Primera BBVA 2011/12,Levante,38,16,7,15,54,50,4,55
Spanish Primera BBVA 2011/12,Osasuna,38,13,15,10,44,61,-17,54
Spanish Primera BBVA 2011/12,Real Mallorca,38,14,10,14,42,46,-4,52
Spanish Primera BBVA 2011/12,Sevilla,38,13,11,14,48,47,1,50
Spanish Primera BBVA 2011/12,Athletic Bilbao,38,12,13,13,49,52,-3,49
Spanish Primera BBVA 2011/12,Getafe,38,12,11,15,40,51,-11,47
Spanish Primera BBVA 2011/12,Real Sociedad,38,12,11,15,46,52,-6,47
Spanish Primera BBVA 2011/12,Real Betis,38,13,8,17,47,56,-9,47
Spanish Primera BBVA 2011/12,Espanyol,38,12,10,16,46,56,-10,46
Spanish Primera BBVA 2011/12,Rayo Vallecano,38,13,4,21,53,73,-20,43
Spanish Primera BBVA 2011/12,Real Zaragoza,38,12,7,19,36,61,-25,43
Spanish Primera BBVA 2011/12,Granada,38,12,6,20,35,56,-21,42
Spanish Primera BBVA 2011/12,Villarreal,38,9,14,15,39,53,-14,41
Spanish Primera BBVA 2011/12,Sporting Gijon,38,10,7,21,42,69,-27,37
Spanish Primera BBVA 2011/12,Racing Santander,38,4,15,19,28,63,-35,27
Spanish Primera BBVA 2012/13,Barcelona,38,32,4,2,115,40,75,100
Spanish Primera BBVA 2012/13,Real Madrid,38,26,7,5,103,42,61,85
Spanish Primera BBVA 2012/13,Atletico Madrid,38,23,7,8,65,31,34,76
Spanish Primera BBVA 2012/13,Real Sociedad,38,18,12,8,70,49,21,66
Spanish Primera BBVA 2012/13,Valencia,38,19,8,11,67,54,13,65
Spanish Primera BBVA 2012/13,Malaga,38,16,9,13,53,50,3,57
Spanish Primera BBVA 2012/13,Real Betis,38,16,8,14,57,56,1,56
Spanish Primera BBVA 2012/13,Rayo Vallecano,38,16,5,17,50,66,-16,53
Spanish Primera BBVA 2012/13,Sevilla,38,14,8,16,58,54,4,50
Spanish Primera BBVA 2012/13,Getafe,38,13,8,17,43,57,-14,47
Spanish Primera BBVA 2012/13,Levante,38,12,10,16,40,57,-17,46
Spanish Primera BBVA 2012/13,Athletic Bilbao,38,12,9,17,44,65,-21,45
Spanish Primera BBVA 2012/13,Espanyol,38,11,11,16,43,52,-9,44
Spanish Primera BBVA 2012/13,Real Valladolid,38,11,10,17,49,58,-9,43
Spanish Primera BBVA 2012/13,Granada,38,11,9,18,37,54,-17,42
Spanish Primera BBVA 2012/13,Osasuna,38,10,9,19,33,50,-17,39
Spanish Primera BBVA 2012/13,Celta Vigo,38,10,7,21,37,52,-15,37
Spanish Primera BBVA 2012/13,Real Mallorca,38,9,9,20,43,72,-29,36
Spanish Primera BBVA 2012/13,Deportivo La Coruna,38,8,11,19,47,70,-23,35
Spanish Primera BBVA 2012/13,Real Zaragoza,38,9,7,22,37,62,-25,34
Spanish Primera BBVA 2013/14,Atletico Madrid,38,28,6,4,77,26,51,90
Spanish Primera BBVA 2013/14,Barcelona,38,27,6,5,100,33,67,87
Spanish Primera BBVA 2013/14,Real Madrid,38,27,6,5,104,38,66,87
Spanish Primera BBVA 2013/14,Athletic Bilbao,38,20,10,8,66,39,27,70
Spanish Primera BBVA 2013/14,Sevilla,38,18,9,11,69,52,17,63
Spanish Primera BBVA 2013/14,Villarreal,38,17,8,13,60,44,16,59
Spanish Primera BBVA 2013/14,Real Sociedad,38,16,11,11,62,55,7,59
Spanish Primera BBVA 2013/14,Valencia,38,13,10,15,51,53,-2,49
Spanish Primera BBVA 2013/14,Celta Vigo,38,14,7,17,49,54,-5,49
Spanish Primera BBVA 2013/14,Levante,38,12,12,14,35,43,-8,48
Spanish Primera BBVA 2013/14,Malaga,38,12,9,17,39,46,-7,45
Spanish Primera BBVA 2013/14,Rayo Vallecano,38,13,4,21,46,80,-34,43
Spanish Primera BBVA 2013/14,Getafe,38,11,9,18,35,54,-19,42
Spanish Primera BBVA 2013/14,Espanyol,38,11,9,18,41,51,-10,42
Spanish Primera BBVA 2013/14,Granada,38,12,5,21,32,56,-24,41
Spanish Primera BBVA 2013/14,Elche,38,9,13,16,30,50,-20,40
Spanish Primera BBVA 2013/14,Almeria,38,11,7,20,43,71,-28,40
Spanish Primera BBVA 2013/14,Osasuna,38,10,9,19,32,62,-30,39
Spanish Primera BBVA 2013/14,Real Valladolid,38,7,15,16,38,60,-22,36
Spanish Primera BBVA 2013/14,Real Betis,38,6,7,25,36,78,-42,25
Spanish Primera BBVA 2014/15,Barcelona,38,30,4,4,110,21,89,94
Spanish Primera BBVA 2014/15,Real Madrid,38,30,2,6,118,38,80,92
Spanish Primera BBVA 2014/15,Atletico Madrid,38,23,9,6,67,29,38,78
Spanish Primera BBVA 2014/15,Valencia,38,22,11,5,70,32,38,77
Spanish Primera BBVA 2014/15,Sevilla,38,23,7,8,71,45,26,76
Spanish Primera BBVA 2014/15,Villarreal,38,16,12,10,48,37,11,60
Spanish Primera BBVA 2014/15,Athletic Bilbao,38,15,10,13,42,41,1,55
Spanish Primera BBVA 2014/15,Celta Vigo,38,13,12,13,47,44,3,51
Spanish Primera BBVA 2014/15,Malaga,38,14,8,16,42,48,-6,50
Spanish Primera BBVA 2014/15,Espanyol,38,13,10,15,47,51,-4,49
Spanish Primera BBVA 2014/15,Rayo Vallecano,38,15,4,19,46,68,-22,49
Spanish Primera BBVA 2014/15,Real Sociedad,38,11,13,14,44,51,-7,46
Spanish Primera BBVA 2014/15,Elche,38,11,8,19,35,62,-27,41
Spanish Primera BBVA 2014/15,Levante,38,9,10,19,34,67,-33,37
Spanish Primera BBVA 2014/15,Getafe,38,10,7,21,33,64,-31,37
Spanish Primera BBVA 2014/15,Deportivo La Coruna,38,7,14,17,35,60,-25,35
Spanish Primera BBVA 2014/15,Granada,38,7,14,17,29,64,-35,35
Spanish Primera BBVA 2014/15,Eibar,38,9,8,21,34,55,-21,35
Spanish Primera BBVA 2014/15,Almeria,38,8,8,22,35,64,-29,32
Spanish Primera BBVA 2014/15,Cordoba,38,3,11,24,22,68,-46,20
Spanish Primera BBVA 2015/16,Barcelona,38,29,4,5,112,29,83,91
Spanish Primera BBVA 2015/16,Real Madrid,38,28,6,4,110,34,76,90
Spanish Primera BBVA 2015/16,Atletico Madrid,38,28,4,6,63,18,45,88
Spanish Primera BBVA 2015/16,Villarreal,38,18,10,10,44,35,9,64
Spanish Primera BBVA 2015/16,Athletic Bilbao,38,18,8,12,58,45,13,62
Spanish Primera BBVA 2015/16,Celta Vigo,38,17,9,12,51,59,-8,60
Spanish Primera BBVA 2015/16,Sevilla,38,14,10,14,51,50,1,52
Spanish Primera BBVA 2015/16,Malaga,38,12,12,14,38,35,3,48
Spanish Primera BBVA 2015/16,Real Sociedad,38,13,9,16,45,48,-3,48
Spanish Primera BBVA 2015/16,Real Betis,38,11,12,15,34,52,-18,45
Spanish Primera BBVA 2015/16,Las Palmas,38,12,8,18,45,53,-8,44
Spanish Primera BBVA 2015/16,Valencia,38,11,11,16,46,48,-2,44
Spanish Primera BBVA 2015/16,Espanyol,38,12,7,19,40,74,-34,43
Spanish Primera BBVA 2015/16,Eibar,38,11,10,17,49,61,-12,43
Spanish Primera BBVA 2015/16,Deportivo La Coruna,38,8,18,12,45,61,-16,42
Spanish Primera BBVA 2015/16,Granada,38,10,9,19,46,69,-23,39
Spanish Primera BBVA 2015/16,Sporting Gijon,38,10,9,19,40,62,-22,39
Spanish Primera BBVA 2015/16,Rayo Vallecano,38,9,11,18,52,73,-21,38
Spanish Primera BBVA 2015/16,Getafe,38,9,9,20,37,67,-30,36
Spanish Primera BBVA 2015/16,Levante,38,8,8,22,37,70,-33,32
Spanish La Liga 2016/17,Real Madrid,38,29,6,3,106,41,65,93
Spanish La Liga 2016/17,Barcelona,38,28,6,4,116,37,79,90
Spanish La Liga 2016/17,Atletico Madrid,38,23,9,6,70,27,43,78
Spanish La Liga 2016/17,Sevilla,38,21,9,8,69,49,20,72
Spanish La Liga 2016/17,Villarreal,38,19,10,9,56,33,23,67
Spanish La Liga 2016/17,Real Sociedad,38,19,7,12,59,53,6,64
Spanish La Liga 2016/17,Athletic Bilbao,38,19,6,13,53,43,10,63
Spanish La Liga 2016/17,Espanyol,38,15,11,12,49,50,-1,56
Spanish La Liga 2016/17,Alaves,38,14,13,11,41,43,-2,55
Spanish La Liga 2016/17,Eibar,38,15,9,14,56,51,5,54
Spanish La Liga 2016/17,Malaga,38,12,10,16,49,55,-6,46
Spanish La Liga 2016/17,Valencia,38,13,7,18,56,65,-9,46
Spanish La Liga 2016/17,Celta Vigo,38,13,6,19,53,69,-16,45
Spanish La Liga 2016/17,Las Palmas,38,10,9,19,53,74,-21,39
Spanish La Liga 2016/17,Real Betis,38,10,9,19,41,64,-23,39
Spanish La Liga 2016/17,Deportivo La Coruna,38,8,12,18,43,61,-18,36
Spanish La Liga 2016/17,Leganes,38,8,11,19,36,55,-19,35
Spanish La Liga 2016/17,Sporting Gijon,38,7,10,21,42,72,-30,31
Spanish La Liga 2016/17,Osasuna,38,4,10,24,40,94,-54,22
Spanish La Liga 2016/17,Granada,38,4,8,26,30,82,-52,20
Spanish La Liga 2017/18,Barcelona,38,28,9,1,99,29,70,93
Spanish La Liga 2017/18,Atletico Madrid,38,23,10,5,58,22,36,79
Spanish La Liga 2017/18,Real Madrid,38,22,10,6,94,44,50,76
Spanish La Liga 2017/18,Valencia,38,22,7,9,65,38,27,73
Spanish La Liga 2017/18,Villarreal,38,18,7,13,57,50,7,61
Spanish La Liga 2017/18,Real Betis,38,18,6,14,60,61,-1,60
Spanish La Liga 2017/18,Sevilla,38,17,7,14,49,58,-9,58
Spanish La Liga 2017/18,Getafe,38,15,10,13,42,33,9,55
Spanish La Liga 2017/18,Eibar,38,14,9,15,44,50,-6,51
Spanish La Liga 2017/18,Girona,38,14,9,15,50,59,-9,51
Spanish La Liga 2017/18,Espanyol,38,12,13,13,36,42,-6,49
Spanish La Liga 2017/18,Real Sociedad,38,14,7,17,66,59,7,49
Spanish La Liga 2017/18,Celta Vigo,38,13,10,15,59,60,-1,49
Spanish La Liga 2017/18,Alaves,38,15,2,21,40,50,-10,47
Spanish La Liga 2017/18,Levante,38,11,13,14,44,58,-14,46
Spanish La Liga 2017/18,Athletic Bilbao,38,10,13,15,41,49,-8,43
Spanish La Liga 2017/18,Leganes,38,12,7,19,34,51,-17,43
Spanish La Liga 2017/18,Deportivo La Coruna,38,6,11,21,38,76,-38,29
Spanish La Liga 2017/18,Las Palmas,38,5,7,26,24,74,-50,22
Spanish La Liga 2017/18,Malaga,38,5,5,28,24,61,-37,20
Spanish La Liga 2018/19,Barcelona,38,26,9,3,90,36,54,87
Spanish La Liga 2018/19,Atletico Madrid,38,22,10,6,55,29,26,76
Spanish La Liga 2018/19,Real Madrid,38,21,5,12,63,46,17,68
Spanish La Liga 2018/19,Valencia,38,15,16,7,51,35,16,61
Spanish La Liga 2018/19,Getafe,38,15,14,9,48,35,13,59
Spanish La Liga 2018/19,Sevilla,38,17,8,13,62,47,15,59
Spanish La Liga 2018/19,Espanyol,38,14,11,13,48,50,-2,53
Spanish La Liga 2018/19,Athletic Bilbao,38,13,14,11,41,45,-4,53
Spanish La Liga 2018/19,Real Sociedad,38,13,11,14,45,46,-1,50
Spanish La Liga 2018/19,Real Betis,38,14,8,16,44,52,-8,50
Spanish La Liga 2018/19,Alaves,38,13,11,14,39,50,-11,50
Spanish La Liga 2018/19,Eibar,38,11,14,13,46,50,-4,47
Spanish La Liga 2018/19,Leganes,38,11,12,15,37,43,-6,45
Spanish La Liga 2018/19,Villarreal,38,10,14,14,49,52,-3,44
Spanish La Liga 2018/19,Levante,38,11,11,16,59,66,-7,44
Spanish La Liga 2018/19,Real Valladolid,38,10,11,17,32,51,-19,41
Spanish La Liga 2018/19,Celta Vigo,38,10,11,17,53,62,-9,41
Spanish La Liga 2018/19,Girona,38,9,10,19,37,53,-16,37
Spanish La Liga 2018/19,SD Huesca,38,7,12,19,43,65,-22,33
Spanish La Liga 2018/19,Rayo Vallecano,38,8,8,22,41,70,-29,32
Spanish La Liga 2019/20,Real Madrid,38,26,9,3,70,25,45,87
Spanish La Liga 2019/20,Barcelona,38,25,7,6,86,38,48,82
Spanish La Liga 2019/20,Atletico Madrid,38,18,16,4,51,27,24,70
Spanish La Liga 2019/20,Sevilla,38,19,13,6,54,34,20,70
Spanish La Liga 2019/20,Villarreal,38,18,6,14,63,49,14,60
Spanish La Liga 2019/20,Real Sociedad,38,16,8,14,56,48,8,56
Spanish La Liga 2019/20,Granada,38,16,8,14,52,45,7,56
Spanish La Liga 2019/20,Getafe,38,14,12,12,43,37,6,54
Spanish La Liga 2019/20,Valencia,38,14,11,13,46,53,-7,53
Spanish La Liga 2019/20,Osasuna,38,13,13,12,46,54,-8,52
Spanish La Liga 2019/20,Athletic Bilbao,38,13,12,13,41,38,3,51
Spanish La Liga 2019/20,Levante,38,14,7,17,47,53,-6,49
Spanish La Liga 2019/20,Real Valladolid,38,9,15,14,32,43,-11,42
Spanish La Liga 2019/20,Eibar,38,11,9,18,39,56,-17,42
Spanish La Liga 2019/20,Real Betis,38,10,11,17,48,60,-12,41
Spanish La Liga 2019/20,Alaves,38,10,9,19,34,59,-25,39
Spanish La Liga 2019/20,Celta Vigo,38,7,16,15,37,49,-12,37
Spanish La Liga 2019/20,Leganes,38,8,12,18,30,51,-21,36
Spanish La Liga 2019/20,Real Mallorca,38,9,6,23,40,65,-25,33
Spanish La Liga 2019/20,Espanyol,38,5,10,23,27,58,-31,25
Spanish La Liga 2020/21,Real Sociedad,8,5,2,1,18,4,14,17
Spanish La Liga 2020/21,Real Madrid,7,5,1,1,13,5,8,16
Spanish La Liga 2020/21,Villarreal,8,4,3,1,10,8,2,15
Spanish La Liga 2020/21,Atletico Madrid,6,4,2,0,13,2,11,14
Spanish La Liga 2020/21,Cadiz,8,4,2,2,8,6,2,14
Spanish La Liga 2020/21,Granada,7,4,2,1,9,9,0,14
Spanish La Liga 2020/21,Real Betis,8,4,0,4,10,12,-2,12
Spanish La Liga 2020/21,Getafe,7,3,2,2,7,6,1,11
Spanish La Liga 2020/21,Osasuna,7,3,1,3,7,7,0,10
Spanish La Liga 2020/21,Elche,6,3,1,2,6,7,-1,10
Spanish La Liga 2020/21,Athletic Bilbao,7,3,0,4,6,7,-1,9
Spanish La Liga 2020/21,Barcelona,6,2,2,2,10,6,4,8
Spanish La Liga 2020/21,Valencia,8,2,2,4,11,13,-2,8
Spanish La Liga 2020/21,Alaves,8,2,2,4,6,9,-3,8
Spanish La Liga 2020/21,Eibar,8,2,2,4,5,8,-3,8
Spanish La Liga 2020/21,Sevilla,6,2,1,3,6,6,0,7
Spanish La Liga 2020/21,Celta Vigo,8,1,3,4,5,14,-9,6
Spanish La Liga 2020/21,Levante,7,1,2,4,7,12,-5,5
Spanish La Liga 2020/21,SD Huesca,8,0,5,3,6,14,-8,5
Spanish La Liga 2020/21,Real Valladolid,8,0,3,5,5,13,-8,3
Coca-Cola Football League One 2009/10,Norwich City,46,29,8,9,89,47,42,95
Coca-Cola Football League One 2009/10,Leeds United,46,25,11,10,77,44,33,86
Coca-Cola Football League One 2009/10,Millwall,46,24,13,9,76,44,32,85
Coca-Cola Football League One 2009/10,Charlton Athletic,46,23,15,8,71,48,23,84
Coca-Cola Football League One 2009/10,Swindon Town,46,22,16,8,73,57,16,82
Coca-Cola Football League One 2009/10,Huddersfield Town,46,23,11,12,82,56,26,80
Coca-Cola Football League One 2009/10,Southampton *,46,23,14,9,85,47,38,73
Coca-Cola Football League One 2009/10,Colchester United,46,20,12,14,64,52,12,72
Coca-Cola Football League One 2009/10,Brentford,46,14,20,12,55,52,3,62
Coca-Cola Football League One 2009/10,Walsall,46,16,14,16,60,63,-3,62
Coca-Cola Football League One 2009/10,Bristol Rovers,46,19,5,22,59,70,-11,62
Coca-Cola Football League One 2009/10,Milton Keynes Dons,46,17,9,20,60,68,-8,60
Coca-Cola Football League One 2009/10,Brighton and Hove Albion,46,15,14,17,56,60,-4,59
Coca-Cola Football League One 2009/10,Carlisle United,46,15,13,18,63,66,-3,58
Coca-Cola Football League One 2009/10,Yeovil Town,46,13,14,19,55,59,-4,53
Coca-Cola Football League One 2009/10,Oldham Athletic,46,13,13,20,39,57,-18,52
Coca-Cola Football League One 2009/10,Leyton Orient,46,13,12,21,53,63,-10,51
Coca-Cola Football League One 2009/10,Exeter City,46,11,18,17,48,60,-12,51
Coca-Cola Football League One 2009/10,Tranmere Rovers,46,14,9,23,45,72,-27,51
Coca-Cola Football League One 2009/10,Hartlepool United *,46,14,11,21,59,67,-8,50
Coca-Cola Football League One 2009/10,Gillingham,46,12,14,20,48,64,-16,50
Coca-Cola Football League One 2009/10,Wycombe Wanderers,46,10,15,21,56,76,-20,45
Coca-Cola Football League One 2009/10,Southend United,46,10,13,23,51,72,-21,43
Coca-Cola Football League One 2009/10,Stockport County,46,5,10,31,35,95,-60,25
npower League 1 2010/11,Brighton and Hove Albion,46,28,11,7,85,40,45,95
npower League 1 2010/11,Southampton,46,28,8,10,86,38,48,92
npower League 1 2010/11,Huddersfield Town,46,25,12,9,77,48,29,87
npower League 1 2010/11,Peterborough United,46,23,10,13,106,75,31,79
npower League 1 2010/11,Milton Keynes Dons,46,23,8,15,67,60,7,77
npower League 1 2010/11,Bournemouth,46,19,14,13,75,54,21,71
npower League 1 2010/11,Leyton Orient,46,19,13,14,71,62,9,70
npower League 1 2010/11,Exeter City,46,20,10,16,66,73,-7,70
npower League 1 2010/11,Rochdale,46,18,14,14,63,55,8,68
npower League 1 2010/11,Colchester United,46,16,14,16,57,63,-6,62
npower League 1 2010/11,Brentford,46,17,10,19,55,62,-7,61
npower League 1 2010/11,Carlisle United,46,16,11,19,60,62,-2,59
npower League 1 2010/11,Charlton Athletic,46,15,14,17,62,66,-4,59
npower League 1 2010/11,Yeovil Town,46,16,11,19,56,66,-10,59
npower League 1 2010/11,Sheffield Wednesday,46,16,10,20,67,67,0,58
npower League 1 2010/11,Hartlepool United,46,15,12,19,47,65,-18,57
npower League 1 2010/11,Oldham Athletic,46,13,17,16,53,60,-7,56
npower League 1 2010/11,Tranmere Rovers,46,15,11,20,53,60,-7,56
npower League 1 2010/11,Notts County,46,14,8,24,46,60,-14,50
npower League 1 2010/11,Walsall,46,12,12,22,56,75,-19,48
npower League 1 2010/11,Dagenham & Redbridge,46,12,11,23,52,70,-18,47
npower League 1 2010/11,Bristol Rovers,46,11,12,23,48,82,-34,45
npower League 1 2010/11,Plymouth Argyle *,46,15,7,24,51,74,-23,42
npower League 1 2010/11,Swindon Town,46,9,14,23,50,72,-22,41
npower League 1 2011/12,Charlton Athletic,46,30,11,5,82,36,46,101
npower League 1 2011/12,Sheffield Wednesday,46,28,9,9,81,48,33,93
npower League 1 2011/12,Sheffield United,46,27,9,10,92,51,41,90
npower League 1 2011/12,Huddersfield Town,46,21,18,7,79,47,32,81
npower League 1 2011/12,Milton Keynes Dons,46,22,14,10,84,47,37,80
npower League 1 2011/12,Stevenage,46,18,19,9,69,44,25,73
npower League 1 2011/12,Notts County,46,21,10,15,75,63,12,73
npower League 1 2011/12,Carlisle United,46,18,15,13,65,66,-1,69
npower League 1 2011/12,Brentford,46,18,13,15,63,52,11,67
npower League 1 2011/12,Colchester United,46,13,20,13,61,66,-5,59
npower League 1 2011/12,Bournemouth,46,15,13,18,48,52,-4,58
npower League 1 2011/12,Tranmere Rovers,46,14,14,18,49,53,-4,56
npower League 1 2011/12,Hartlepool United,46,14,14,18,50,55,-5,56
npower League 1 2011/12,Bury,46,15,11,20,60,79,-19,56
npower League 1 2011/12,Preston North End,46,13,15,18,54,68,-14,54
npower League 1 2011/12,Oldham Athletic,46,14,12,20,50,66,-16,54
npower League 1 2011/12,Yeovil Town,46,14,12,20,59,80,-21,54
npower League 1 2011/12,Scunthorpe United,46,10,22,14,55,59,-4,52
npower League 1 2011/12,Walsall,46,10,20,16,51,57,-6,50
npower League 1 2011/12,Leyton Orient,46,13,11,22,48,75,-27,50
npower League 1 2011/12,Wycombe Wanderers,46,11,10,25,65,88,-23,43
npower League 1 2011/12,Chesterfield,46,10,12,24,56,81,-25,42
npower League 1 2011/12,Exeter City,46,10,12,24,46,75,-29,42
npower League 1 2011/12,Rochdale,46,8,14,24,47,81,-34,38
npower League 1 2012/13,Doncaster Rovers,46,25,9,12,62,44,18,84
npower League 1 2012/13,Bournemouth,46,24,11,11,76,53,23,83
npower League 1 2012/13,Brentford,46,21,16,9,62,47,15,79
npower League 1 2012/13,Yeovil Town,46,23,8,15,71,56,15,77
npower League 1 2012/13,Sheffield United,46,19,18,9,56,42,14,75
npower League 1 2012/13,Swindon Town,46,20,14,12,72,39,33,74
npower League 1 2012/13,Leyton Orient,46,21,8,17,55,48,7,71
npower League 1 2012/13,Milton Keynes Dons,46,19,13,14,62,45,17,70
npower League 1 2012/13,Walsall,46,17,17,12,65,58,7,68
npower League 1 2012/13,Crawley Town,46,18,14,14,59,58,1,68
npower League 1 2012/13,Tranmere Rovers,46,19,10,17,58,48,10,67
npower League 1 2012/13,Notts County,46,16,17,13,61,49,12,65
npower League 1 2012/13,Crewe Alexandra,46,18,10,18,54,62,-8,64
npower League 1 2012/13,Preston North End,46,14,17,15,54,49,5,59
npower League 1 2012/13,Coventry City *,46,18,11,17,66,59,7,55
npower League 1 2012/13,Shrewsbury Town,46,13,16,17,54,60,-6,55
npower League 1 2012/13,Carlisle United,46,14,13,19,56,77,-21,55
npower League 1 2012/13,Stevenage,46,15,9,22,47,64,-17,54
npower League 1 2012/13,Oldham Athletic,46,14,9,23,46,59,-13,51
npower League 1 2012/13,Colchester United,46,14,9,23,47,68,-21,51
npower League 1 2012/13,Scunthorpe United,46,13,9,24,49,73,-24,48
npower League 1 2012/13,Bury,46,9,14,23,45,73,-28,41
npower League 1 2012/13,Hartlepool United,46,9,14,23,39,67,-28,41
npower League 1 2012/13,Portsmouth *,46,10,12,24,51,69,-18,32
Sky Bet League 1 2013/14,Wolverhampton Wanderers,46,31,10,5,89,31,58,103
Sky Bet League 1 2013/14,Brentford,46,28,10,8,72,43,29,94
Sky Bet League 1 2013/14,Leyton Orient,46,25,11,10,85,45,40,86
Sky Bet League 1 2013/14,Rotherham United,46,24,14,8,86,58,28,86
Sky Bet League 1 2013/14,Preston North End,46,23,16,7,72,46,26,85
Sky Bet League 1 2013/14,Peterborough United,46,23,5,18,72,58,14,74
Sky Bet League 1 2013/14,Sheffield United,46,18,13,15,48,46,2,67
Sky Bet League 1 2013/14,Swindon Town,46,19,9,18,63,59,4,66
Sky Bet League 1 2013/14,Port Vale,46,18,7,21,59,73,-14,61
Sky Bet League 1 2013/14,Milton Keynes Dons,46,17,9,20,63,65,-2,60
Sky Bet League 1 2013/14,Bradford City,46,14,17,15,57,54,3,59
Sky Bet League 1 2013/14,Bristol City,46,13,19,14,70,67,3,58
Sky Bet League 1 2013/14,Walsall,46,14,16,16,49,49,0,58
Sky Bet League 1 2013/14,Crawley Town,46,14,15,17,48,54,-6,57
Sky Bet League 1 2013/14,Oldham Athletic,46,14,14,18,50,59,-9,56
Sky Bet League 1 2013/14,Colchester United,46,13,14,19,53,61,-8,53
Sky Bet League 1 2013/14,Gillingham,46,15,8,23,60,79,-19,53
Sky Bet League 1 2013/14,Coventry City *,46,16,13,17,74,77,-3,51
Sky Bet League 1 2013/14,Crewe Alexandra,46,13,12,21,54,80,-26,51
Sky Bet League 1 2013/14,Notts County,46,15,5,26,64,77,-13,50
Sky Bet League 1 2013/14,Tranmere Rovers,46,12,11,23,52,79,-27,47
Sky Bet League 1 2013/14,Carlisle United,46,11,12,23,43,76,-33,45
Sky Bet League 1 2013/14,Shrewsbury Town,46,9,15,22,44,65,-21,42
Sky Bet League 1 2013/14,Stevenage,46,11,9,26,46,72,-26,42
Sky Bet League 1 2014/15,Bristol City,46,29,12,5,96,38,58,99
Sky Bet League 1 2014/15,Milton Keynes Dons,46,27,10,9,101,44,57,91
Sky Bet League 1 2014/15,Preston North End,46,25,14,7,79,40,39,89
Sky Bet League 1 2014/15,Swindon Town,46,23,10,13,76,57,19,79
Sky Bet League 1 2014/15,Sheffield United,46,19,14,13,66,53,13,71
Sky Bet League 1 2014/15,Chesterfield,46,19,12,15,68,55,13,69
Sky Bet League 1 2014/15,Bradford City,46,17,14,15,55,55,0,65
Sky Bet League 1 2014/15,Rochdale,46,19,6,21,72,66,6,63
Sky Bet League 1 2014/15,Peterborough United,46,18,9,19,53,56,-3,63
Sky Bet League 1 2014/15,Fleetwood Town,46,17,12,17,49,52,-3,63
Sky Bet League 1 2014/15,Barnsley,46,17,11,18,62,61,1,62
Sky Bet League 1 2014/15,Gillingham,46,16,14,16,65,66,-1,62
Sky Bet League 1 2014/15,Doncaster Rovers,46,16,13,17,58,62,-4,61
Sky Bet League 1 2014/15,Walsall,46,14,17,15,50,54,-4,59
Sky Bet League 1 2014/15,Oldham Athletic,46,14,15,17,54,67,-13,57
Sky Bet League 1 2014/15,Scunthorpe United,46,14,14,18,62,75,-13,56
Sky Bet League 1 2014/15,Coventry City,46,13,16,17,49,60,-11,55
Sky Bet League 1 2014/15,Port Vale,46,15,9,22,55,65,-10,54
Sky Bet League 1 2014/15,Colchester United,46,14,10,22,58,77,-19,52
Sky Bet League 1 2014/15,Crewe Alexandra,46,14,10,22,43,75,-32,52
Sky Bet League 1 2014/15,Notts County,46,12,14,20,45,63,-18,50
Sky Bet League 1 2014/15,Crawley Town,46,13,11,22,53,79,-26,50
Sky Bet League 1 2014/15,Leyton Orient,46,12,13,21,59,69,-10,49
Sky Bet League 1 2014/15,Yeovil Town,46,10,10,26,36,75,-39,40
Sky Bet League 1 2015/16,Wigan Athletic,46,24,15,7,82,45,37,87
Sky Bet League 1 2015/16,Burton Albion,46,25,10,11,57,37,20,85
Sky Bet League 1 2015/16,Walsall,46,24,12,10,71,49,22,84
Sky Bet League 1 2015/16,Millwall,46,24,9,13,73,49,24,81
Sky Bet League 1 2015/16,Bradford City,46,23,11,12,55,40,15,80
Sky Bet League 1 2015/16,Barnsley,46,22,8,16,70,54,16,74
Sky Bet League 1 2015/16,Scunthorpe United,46,21,11,14,60,47,13,74
Sky Bet League 1 2015/16,Coventry City,46,19,12,15,67,49,18,69
Sky Bet League 1 2015/16,Gillingham,46,19,12,15,71,56,15,69
Sky Bet League 1 2015/16,Rochdale,46,19,12,15,68,61,7,69
Sky Bet League 1 2015/16,Sheffield United,46,18,12,16,64,59,5,66
Sky Bet League 1 2015/16,Port Vale,46,18,11,17,56,58,-2,65
Sky Bet League 1 2015/16,Peterborough United,46,19,6,21,82,73,9,63
Sky Bet League 1 2015/16,Southend United,46,16,11,19,58,64,-6,59
Sky Bet League 1 2015/16,Swindon Town,46,16,11,19,64,71,-7,59
Sky Bet League 1 2015/16,Bury,46,16,12,18,56,73,-17,60
Sky Bet League 1 2015/16,Oldham Athletic,46,12,18,16,44,58,-14,54
Sky Bet League 1 2015/16,Chesterfield,46,15,8,23,58,70,-12,53
Sky Bet League 1 2015/16,Fleetwood Town,46,12,15,19,52,56,-4,51
Sky Bet League 1 2015/16,Shrewsbury Town,46,13,11,22,58,79,-21,50
Sky Bet League 1 2015/16,Doncaster Rovers,46,11,13,22,48,64,-16,46
Sky Bet League 1 2015/16,Blackpool,46,12,10,24,40,63,-23,46
Sky Bet League 1 2015/16,Colchester United,46,9,13,24,57,99,-42,40
Sky Bet League 1 2015/16,Crewe Alexandra,46,7,13,26,46,83,-37,34
Sky Bet League One 2016/17,Sheffield United,46,30,10,6,92,47,45,100
Sky Bet League One 2016/17,Bolton Wanderers,46,25,11,10,68,36,32,86
Sky Bet League One 2016/17,Scunthorpe United,46,24,10,12,80,54,26,82
Sky Bet League One 2016/17,Fleetwood Town,46,23,13,10,64,43,21,82
Sky Bet League One 2016/17,Bradford City,46,20,19,7,62,43,19,79
Sky Bet League One 2016/17,Millwall,46,20,13,13,66,57,9,73
Sky Bet League One 2016/17,Southend United,46,20,12,14,70,53,17,72
Sky Bet League One 2016/17,Oxford United,46,20,9,17,65,52,13,69
Sky Bet League One 2016/17,Rochdale,46,19,12,15,71,62,9,69
Sky Bet League One 2016/17,Bristol Rovers,46,18,12,16,68,70,-2,66
Sky Bet League One 2016/17,Peterborough United,46,17,11,18,62,62,0,62
Sky Bet League One 2016/17,Milton Keynes Dons,46,16,13,17,60,58,2,61
Sky Bet League One 2016/17,Charlton Athletic,46,14,18,14,60,53,7,60
Sky Bet League One 2016/17,Walsall,46,14,16,16,51,58,-7,58
Sky Bet League One 2016/17,AFC Wimbledon,46,13,18,15,52,55,-3,57
Sky Bet League One 2016/17,Northampton Town,46,14,11,21,60,73,-13,53
Sky Bet League One 2016/17,Oldham Athletic,46,12,17,17,31,44,-13,53
Sky Bet League One 2016/17,Shrewsbury Town,46,13,12,21,46,63,-17,51
Sky Bet League One 2016/17,Bury,46,13,11,22,61,73,-12,50
Sky Bet League One 2016/17,Gillingham,46,12,14,20,59,79,-20,50
Sky Bet League One 2016/17,Port Vale,46,12,13,21,45,70,-25,49
Sky Bet League One 2016/17,Swindon Town,46,11,11,24,44,66,-22,44
Sky Bet League One 2016/17,Coventry City,46,9,12,25,37,68,-31,39
Sky Bet League One 2016/17,Chesterfield,46,9,10,27,43,78,-35,37
Sky Bet League One 2017/18,Wigan Athletic,46,29,11,6,89,29,60,98
Sky Bet League One 2017/18,Blackburn Rovers,46,28,12,6,82,40,42,96
Sky Bet League One 2017/18,Shrewsbury Town,46,25,12,9,60,39,21,87
Sky Bet League One 2017/18,Rotherham United,46,24,7,15,73,53,20,79
Sky Bet League One 2017/18,Scunthorpe United,46,19,17,10,65,50,15,74
Sky Bet League One 2017/18,Charlton Athletic,46,20,11,15,58,51,7,71
Sky Bet League One 2017/18,Plymouth Argyle,46,19,11,16,58,59,-1,68
Sky Bet League One 2017/18,Portsmouth,46,20,6,20,57,56,1,66
Sky Bet League One 2017/18,Peterborough United,46,17,13,16,68,60,8,64
Sky Bet League One 2017/18,Southend United,46,17,12,17,58,62,-4,63
Sky Bet League One 2017/18,Bradford City,46,18,9,19,57,67,-10,63
Sky Bet League One 2017/18,Blackpool,46,15,15,16,60,55,5,60
Sky Bet League One 2017/18,Bristol Rovers,46,16,11,19,60,66,-6,59
Sky Bet League One 2017/18,Fleetwood Town,46,16,9,21,59,68,-9,57
Sky Bet League One 2017/18,Doncaster Rovers,46,13,17,16,52,52,0,56
Sky Bet League One 2017/18,Oxford United,46,15,11,20,61,66,-5,56
Sky Bet League One 2017/18,Gillingham,46,13,17,16,50,55,-5,56
Sky Bet League One 2017/18,AFC Wimbledon,46,13,14,19,47,58,-11,53
Sky Bet League One 2017/18,Walsall,46,13,13,20,53,66,-13,52
Sky Bet League One 2017/18,Rochdale,46,11,18,17,49,57,-8,51
Sky Bet League One 2017/18,Oldham Athletic,46,11,17,18,58,75,-17,50
Sky Bet League One 2017/18,Northampton Town,46,12,11,23,43,77,-34,47
Sky Bet League One 2017/18,Milton Keynes Dons,46,11,12,23,43,69,-26,45
Sky Bet League One 2017/18,Bury,46,8,12,26,41,71,-30,36
Sky Bet League One 2018/19,Luton Town,46,27,13,6,90,42,48,94
Sky Bet League One 2018/19,Barnsley,46,26,13,7,80,39,41,91
Sky Bet League One 2018/19,Charlton Athletic,46,26,10,10,73,40,33,88
Sky Bet League One 2018/19,Portsmouth,46,25,13,8,83,51,32,88
Sky Bet League One 2018/19,Sunderland,46,22,19,5,80,47,33,85
Sky Bet League One 2018/19,Doncaster Rovers,46,20,13,13,76,58,18,73
Sky Bet League One 2018/19,Peterborough United,46,20,12,14,71,62,9,72
Sky Bet League One 2018/19,Coventry City,46,18,11,17,54,54,0,65
Sky Bet League One 2018/19,Burton Albion,46,17,12,17,66,57,9,63
Sky Bet League One 2018/19,Blackpool,46,15,17,14,50,52,-2,62
Sky Bet League One 2018/19,Fleetwood Town,46,16,13,17,58,52,6,61
Sky Bet League One 2018/19,Oxford United,46,15,15,16,58,64,-6,60
Sky Bet League One 2018/19,Gillingham,46,15,10,21,61,72,-11,55
Sky Bet League One 2018/19,Accrington Stanley,46,14,13,19,51,67,-16,55
Sky Bet League One 2018/19,Bristol Rovers,46,13,15,18,47,50,-3,54
Sky Bet League One 2018/19,Rochdale,46,15,9,22,54,87,-33,54
Sky Bet League One 2018/19,Wycombe Wanderers,46,14,11,21,55,67,-12,53
Sky Bet League One 2018/19,Shrewsbury Town,46,12,16,18,51,59,-8,52
Sky Bet League One 2018/19,Southend United,46,14,8,24,55,68,-13,50
Sky Bet League One 2018/19,AFC Wimbledon,46,13,11,22,42,63,-21,50
Sky Bet League One 2018/19,Plymouth Argyle,46,13,11,22,56,80,-24,50
Sky Bet League One 2018/19,Walsall,46,12,11,23,49,71,-22,47
Sky Bet League One 2018/19,Scunthorpe United,46,12,10,24,53,83,-30,46
Sky Bet League One 2018/19,Bradford City,46,11,8,27,49,77,-28,41
Sky Bet League One 2019/20,Coventry City,34,18,13,3,48,30,18,67
Sky Bet League One 2019/20,Rotherham United,35,18,8,9,61,38,23,62
Sky Bet League One 2019/20,Wycombe Wanderers,34,17,8,9,45,40,5,59
Sky Bet League One 2019/20,Oxford United,35,17,9,9,61,37,24,60
Sky Bet League One 2019/20,Portsmouth,35,17,9,9,53,36,17,60
Sky Bet League One 2019/20,Fleetwood Town,35,16,12,7,51,38,13,60
Sky Bet League One 2019/20,Peterborough United,35,17,8,10,68,40,28,59
Sky Bet League One 2019/20,Sunderland,36,16,11,9,48,32,16,59
Sky Bet League One 2019/20,Doncaster Rovers,34,15,9,10,51,33,18,54
Sky Bet League One 2019/20,Gillingham,35,12,15,8,42,34,8,51
Sky Bet League One 2019/20,Ipswich Town,36,14,10,12,46,36,10,52
Sky Bet League One 2019/20,Burton Albion,35,12,12,11,50,50,0,48
Sky Bet League One 2019/20,Blackpool,35,11,12,12,44,43,1,45
Sky Bet League One 2019/20,Bristol Rovers,35,12,9,14,38,49,-11,45
Sky Bet League One 2019/20,Shrewsbury Town,34,10,11,13,31,42,-11,41
Sky Bet League One 2019/20,Lincoln City,35,12,6,17,44,46,-2,42
Sky Bet League One 2019/20,Accrington Stanley,35,10,10,15,47,53,-6,40
Sky Bet League One 2019/20,Rochdale,34,10,6,18,39,57,-18,36
Sky Bet League One 2019/20,Milton Keynes Dons,35,10,7,18,36,47,-11,37
Sky Bet League One 2019/20,AFC Wimbledon,35,8,11,16,39,52,-13,35
Sky Bet League One 2019/20,Tranmere Rovers,34,8,8,18,36,60,-24,32
Sky Bet League One 2019/20,Southend United,35,4,7,24,39,85,-46,19
Sky Bet League One 2019/20,Bolton Wanderers *,34,5,11,18,27,66,-39,14
Sky Bet League One 2020/21,Peterborough United,10,7,1,2,19,9,10,22
Sky Bet League One 2020/21,Ipswich Town,10,7,1,2,16,7,9,22
Sky Bet League One 2020/21,Lincoln City,10,7,1,2,14,6,8,22
Sky Bet League One 2020/21,Hull City,10,7,0,3,16,9,7,21
Sky Bet League One 2020/21,Charlton Athletic,9,6,1,2,11,5,6,19
Sky Bet League One 2020/21,Sunderland,9,5,3,1,12,6,6,18
Sky Bet League One 2020/21,Portsmouth,10,5,2,3,16,9,7,17
Sky Bet League One 2020/21,Doncaster Rovers,9,5,1,3,16,9,7,16
Sky Bet League One 2020/21,Fleetwood Town,10,5,1,4,13,8,5,16
Sky Bet League One 2020/21,Plymouth Argyle,9,4,3,2,13,11,2,15
Sky Bet League One 2020/21,AFC Wimbledon,10,3,4,3,12,12,0,13
Sky Bet League One 2020/21,Accrington Stanley,7,4,0,3,9,10,-1,12
Sky Bet League One 2020/21,Bristol Rovers,9,3,3,3,10,13,-3,12
Sky Bet League One 2020/21,Rochdale,10,3,3,4,10,15,-5,12
Sky Bet League One 2020/21,Crewe Alexandra,9,3,1,5,8,8,0,10
Sky Bet League One 2020/21,Blackpool,10,3,1,6,9,14,-5,10
Sky Bet League One 2020/21,Gillingham,10,3,1,6,9,15,-6,10
Sky Bet League One 2020/21,Northampton Town,10,3,1,6,10,20,-10,10
Sky Bet League One 2020/21,Milton Keynes Dons,10,2,3,5,11,13,-2,9
Sky Bet League One 2020/21,Swindon Town,8,3,0,5,11,14,-3,9
Sky Bet League One 2020/21,Wigan Athletic,10,2,1,7,8,17,-9,7
Sky Bet League One 2020/21,Shrewsbury Town,9,1,3,5,6,13,-7,6
Sky Bet League One 2020/21,Burton Albion,10,1,3,6,12,20,-8,6
Sky Bet League One 2020/21,Oxford United,8,2,0,6,8,16,-8,6
Coca-Cola Football League Two 2009/10,Notts County,46,27,12,7,96,31,65,93
Coca-Cola Football League Two 2009/10,Bournemouth,46,25,8,13,61,44,17,83
Coca-Cola Football League Two 2009/10,Rochdale,46,25,7,14,82,48,34,82
Coca-Cola Football League Two 2009/10,Morecambe,46,20,13,13,73,64,9,73
Coca-Cola Football League Two 2009/10,Rotherham United,46,21,10,15,55,52,3,73
Coca-Cola Football League Two 2009/10,Aldershot Town,46,20,12,14,69,56,13,72
Coca-Cola Football League Two 2009/10,Dagenham & Redbridge,46,20,12,14,69,58,11,72
Coca-Cola Football League Two 2009/10,Chesterfield,46,21,7,18,61,62,-1,70
Coca-Cola Football League Two 2009/10,Bury,46,19,12,15,54,59,-5,69
Coca-Cola Football League Two 2009/10,Port Vale,46,17,17,12,61,50,11,68
Coca-Cola Football League Two 2009/10,Northampton Town,46,18,13,15,62,53,9,67
Coca-Cola Football League Two 2009/10,Shrewsbury Town,46,17,12,17,55,54,1,63
Coca-Cola Football League Two 2009/10,Burton Albion,46,17,11,18,71,71,0,62
Coca-Cola Football League Two 2009/10,Bradford City,46,16,14,16,59,62,-3,62
Coca-Cola Football League Two 2009/10,Accrington Stanley,46,18,7,21,62,74,-12,61
Coca-Cola Football League Two 2009/10,Hereford FC,46,17,8,21,54,65,-11,59
Coca-Cola Football League Two 2009/10,Torquay United,46,14,15,17,64,55,9,57
Coca-Cola Football League Two 2009/10,Crewe Alexandra,46,15,10,21,68,73,-5,55
Coca-Cola Football League Two 2009/10,Macclesfield Town,46,12,18,16,49,58,-9,54
Coca-Cola Football League Two 2009/10,Lincoln City,46,13,11,22,42,65,-23,50
Coca-Cola Football League Two 2009/10,Barnet,46,12,12,22,47,63,-16,48
Coca-Cola Football League Two 2009/10,Cheltenham Town,46,10,18,18,54,71,-17,48
Coca-Cola Football League Two 2009/10,Grimsby Town,46,9,17,20,45,71,-26,44
Coca-Cola Football League Two 2009/10,Darlington,46,8,6,32,33,87,-54,30
npower League 2 2010/11,Chesterfield,46,24,14,8,85,51,34,86
npower League 2 2010/11,Bury,46,23,12,11,82,50,32,81
npower League 2 2010/11,Wycombe Wanderers,46,22,14,10,69,50,19,80
npower League 2 2010/11,Shrewsbury Town,46,22,13,11,72,49,23,79
npower League 2 2010/11,Accrington Stanley,46,18,19,9,73,55,18,73
npower League 2 2010/11,Stevenage,46,18,15,13,62,45,17,69
npower League 2 2010/11,Torquay United *,46,17,18,11,74,53,21,68
npower League 2 2010/11,Gillingham,46,17,17,12,67,57,10,68
npower League 2 2010/11,Rotherham United,46,17,15,14,75,60,15,66
npower League 2 2010/11,Crewe Alexandra,46,18,11,17,87,65,22,65
npower League 2 2010/11,Port Vale,46,17,14,15,54,49,5,65
npower League 2 2010/11,Oxford United,46,17,12,17,58,60,-2,63
npower League 2 2010/11,Southend United,46,16,13,17,62,56,6,61
npower League 2 2010/11,Aldershot Town,46,14,19,13,54,54,0,61
npower League 2 2010/11,Macclesfield Town,46,14,13,19,59,73,-14,55
npower League 2 2010/11,Northampton Town,46,11,19,16,63,71,-8,52
npower League 2 2010/11,Cheltenham Town,46,13,13,20,56,77,-21,52
npower League 2 2010/11,Bradford City,46,15,7,24,43,68,-25,52
npower League 2 2010/11,Burton Albion,46,12,15,19,56,70,-14,51
npower League 2 2010/11,Morecambe,46,13,12,21,54,73,-19,51
npower League 2 2010/11,Hereford FC *,46,12,17,17,50,66,-16,50
npower League 2 2010/11,Barnet,46,12,12,22,58,77,-19,48
npower League 2 2010/11,Lincoln City,46,13,8,25,45,81,-36,47
npower League 2 2010/11,Stockport County,46,9,14,23,48,96,-48,41
npower League 2 2011/12,Swindon Town,46,29,6,11,75,32,43,93
npower League 2 2011/12,Shrewsbury Town,46,26,10,10,66,41,25,88
npower League 2 2011/12,Crawley Town,46,23,15,8,76,54,22,84
npower League 2 2011/12,Southend United,46,25,8,13,77,48,29,83
npower League 2 2011/12,Torquay United,46,23,12,11,63,50,13,81
npower League 2 2011/12,Cheltenham Town,46,23,8,15,66,50,16,77
npower League 2 2011/12,Crewe Alexandra,46,20,12,14,67,59,8,72
npower League 2 2011/12,Gillingham,46,20,10,16,79,62,17,70
npower League 2 2011/12,Oxford United,46,17,17,12,59,48,11,68
npower League 2 2011/12,Rotherham United,46,18,13,15,67,63,4,67
npower League 2 2011/12,Aldershot Town,46,19,9,18,54,52,2,66
npower League 2 2011/12,Port Vale *,46,20,9,17,68,60,8,59
npower League 2 2011/12,Bristol Rovers,46,15,12,19,60,70,-10,57
npower League 2 2011/12,Accrington Stanley,46,14,15,17,54,66,-12,57
npower League 2 2011/12,Morecambe,46,14,14,18,63,57,6,56
npower League 2 2011/12,AFC Wimbledon,46,15,9,22,62,78,-16,54
npower League 2 2011/12,Burton Albion,46,14,12,20,54,81,-27,54
npower League 2 2011/12,Bradford City,46,12,14,20,54,59,-5,50
npower League 2 2011/12,Dagenham & Redbridge,46,14,8,24,50,72,-22,50
npower League 2 2011/12,Northampton Town,46,12,12,22,56,79,-23,48
npower League 2 2011/12,Plymouth Argyle,46,10,16,20,47,64,-17,46
npower League 2 2011/12,Barnet,46,12,10,24,52,79,-27,46
npower League 2 2011/12,Hereford FC,46,10,14,22,50,70,-20,44
npower League 2 2011/12,Macclesfield Town,46,8,13,25,39,64,-25,37
npower League 2 2012/13,Gillingham,46,23,14,9,66,39,27,83
npower League 2 2012/13,Rotherham United,46,24,7,15,74,59,15,79
npower League 2 2012/13,Port Vale,46,21,15,10,87,52,35,78
npower League 2 2012/13,Burton Albion,46,22,10,14,71,65,6,76
npower League 2 2012/13,Cheltenham Town,46,20,15,11,58,51,7,75
npower League 2 2012/13,Northampton Town,46,21,10,15,64,55,9,73
npower League 2 2012/13,Bradford City,46,18,15,13,63,52,11,69
npower League 2 2012/13,Chesterfield,46,18,13,15,60,45,15,67
npower League 2 2012/13,Oxford United,46,19,8,19,60,61,-1,65
npower League 2 2012/13,Exeter City,46,18,10,18,63,62,1,64
npower League 2 2012/13,Southend United,46,16,13,17,61,55,6,61
npower League 2 2012/13,Rochdale,46,16,13,17,68,70,-2,61
npower League 2 2012/13,Fleetwood Town,46,15,15,16,55,57,-2,60
npower League 2 2012/13,Bristol Rovers,46,16,12,18,60,69,-9,60
npower League 2 2012/13,Wycombe Wanderers,46,17,9,20,50,60,-10,60
npower League 2 2012/13,Morecambe,46,15,13,18,55,61,-6,58
npower League 2 2012/13,York City,46,12,19,15,50,60,-10,55
npower League 2 2012/13,Accrington Stanley,46,14,12,20,51,68,-17,54
npower League 2 2012/13,Torquay United,46,13,14,19,55,62,-7,53
npower League 2 2012/13,AFC Wimbledon,46,14,11,21,54,76,-22,53
npower League 2 2012/13,Plymouth Argyle,46,13,13,20,46,55,-9,52
npower League 2 2012/13,Dagenham & Redbridge,46,13,12,21,55,62,-7,51
npower League 2 2012/13,Barnet,46,13,12,21,47,59,-12,51
npower League 2 2012/13,Aldershot Town,46,11,15,20,42,60,-18,48
Sky Bet League 2 2013/14,Chesterfield,46,23,15,8,71,40,31,84
Sky Bet League 2 2013/14,Scunthorpe United,46,20,21,5,68,44,24,81
Sky Bet League 2 2013/14,Rochdale,46,24,9,13,69,48,21,81
Sky Bet League 2 2013/14,Fleetwood Town,46,22,10,14,66,52,14,76
Sky Bet League 2 2013/14,Southend United,46,19,15,12,56,39,17,72
Sky Bet League 2 2013/14,Burton Albion,46,19,15,12,47,42,5,72
Sky Bet League 2 2013/14,York City,46,18,17,11,52,41,11,71
Sky Bet League 2 2013/14,Oxford United,46,16,14,16,53,50,3,62
Sky Bet League 2 2013/14,Dagenham & Redbridge,46,15,15,16,53,59,-6,60
Sky Bet League 2 2013/14,Plymouth Argyle,46,16,12,18,51,58,-7,60
Sky Bet League 2 2013/14,Mansfield Town,46,15,15,16,49,58,-9,60
Sky Bet League 2 2013/14,Bury,46,13,20,13,59,51,8,59
Sky Bet League 2 2013/14,Portsmouth,46,14,17,15,56,66,-10,59
Sky Bet League 2 2013/14,Newport County AFC,46,14,16,16,56,59,-3,58
Sky Bet League 2 2013/14,Accrington Stanley,46,14,15,17,54,56,-2,57
Sky Bet League 2 2013/14,Exeter City,46,14,13,19,54,57,-3,55
Sky Bet League 2 2013/14,Cheltenham Town,46,13,16,17,53,63,-10,55
Sky Bet League 2 2013/14,Morecambe,46,13,15,18,52,64,-12,54
Sky Bet League 2 2013/14,Hartlepool United,46,14,11,21,50,56,-6,53
Sky Bet League 2 2013/14,AFC Wimbledon *,46,14,14,18,49,57,-8,53
Sky Bet League 2 2013/14,Northampton Town,46,13,14,19,42,57,-15,53
Sky Bet League 2 2013/14,Wycombe Wanderers,46,12,14,20,46,54,-8,50
Sky Bet League 2 2013/14,Bristol Rovers,46,12,14,20,43,54,-11,50
Sky Bet League 2 2013/14,Torquay United,46,12,9,25,42,66,-24,45
Sky Bet League 2 2014/15,Burton Albion,46,28,10,8,69,39,30,94
Sky Bet League 2 2014/15,Shrewsbury Town,46,27,8,11,67,31,36,89
Sky Bet League 2 2014/15,Bury,46,26,7,13,60,40,20,85
Sky Bet League 2 2014/15,Wycombe Wanderers,46,23,15,8,67,45,22,84
Sky Bet League 2 2014/15,Southend United,46,24,12,10,54,38,16,84
Sky Bet League 2 2014/15,Stevenage,46,20,12,14,62,54,8,72
Sky Bet League 2 2014/15,Plymouth Argyle,46,20,11,15,55,37,18,71
Sky Bet League 2 2014/15,Luton Town,46,19,11,16,54,44,10,68
Sky Bet League 2 2014/15,Newport County AFC,46,18,11,17,51,54,-3,65
Sky Bet League 2 2014/15,Exeter City,46,17,13,16,61,65,-4,64
Sky Bet League 2 2014/15,Morecambe,46,17,12,17,53,52,1,63
Sky Bet League 2 2014/15,Northampton Town,46,18,7,21,67,62,5,61
Sky Bet League 2 2014/15,Oxford United,46,15,16,15,50,49,1,61
Sky Bet League 2 2014/15,Dagenham & Redbridge,46,17,8,21,58,59,-1,59
Sky Bet League 2 2014/15,AFC Wimbledon,46,14,16,16,54,60,-6,58
Sky Bet League 2 2014/15,Portsmouth,46,14,15,17,52,54,-2,57
Sky Bet League 2 2014/15,Accrington Stanley,46,15,11,20,58,77,-19,56
Sky Bet League 2 2014/15,York City,46,11,19,16,46,51,-5,52
Sky Bet League 2 2014/15,Cambridge United,46,13,12,21,61,66,-5,51
Sky Bet League 2 2014/15,Carlisle United,46,14,8,24,56,74,-18,50
Sky Bet League 2 2014/15,Mansfield Town,46,13,9,24,38,62,-24,48
Sky Bet League 2 2014/15,Hartlepool United,46,12,9,25,39,70,-31,45
Sky Bet League 2 2014/15,Cheltenham Town,46,9,14,23,40,67,-27,41
Sky Bet League 2 2014/15,Tranmere Rovers,46,9,12,25,45,67,-22,39
Sky Bet League 2 2015/16,Northampton Town,46,29,12,5,82,46,36,99
Sky Bet League 2 2015/16,Oxford United,46,24,14,8,84,41,43,86
Sky Bet League 2 2015/16,Bristol Rovers,46,26,7,13,77,46,31,85
Sky Bet League 2 2015/16,Accrington Stanley,46,24,13,9,74,48,26,85
Sky Bet League 2 2015/16,Plymouth Argyle,46,24,9,13,72,46,26,81
Sky Bet League 2 2015/16,Portsmouth,46,21,15,10,75,44,31,78
Sky Bet League 2 2015/16,AFC Wimbledon,46,21,12,13,64,50,14,75
Sky Bet League 2 2015/16,Leyton Orient,46,19,12,15,60,61,-1,69
Sky Bet League 2 2015/16,Cambridge United,46,18,14,14,66,55,11,68
Sky Bet League 2 2015/16,Carlisle United,46,17,16,13,67,62,5,67
Sky Bet League 2 2015/16,Luton Town,46,19,9,18,63,61,2,66
Sky Bet League 2 2015/16,Mansfield Town,46,17,13,16,61,53,8,64
Sky Bet League 2 2015/16,Wycombe Wanderers,46,17,13,16,45,44,1,64
Sky Bet League 2 2015/16,Exeter City,46,17,13,16,63,65,-2,64
Sky Bet League 2 2015/16,Barnet,46,17,11,18,67,68,-1,62
Sky Bet League 2 2015/16,Hartlepool United,46,15,6,25,49,72,-23,51
Sky Bet League 2 2015/16,Notts County,46,14,9,23,54,83,-29,51
Sky Bet League 2 2015/16,Stevenage,46,11,15,20,52,67,-15,48
Sky Bet League 2 2015/16,Yeovil Town,46,11,15,20,43,59,-16,48
Sky Bet League 2 2015/16,Crawley Town,46,13,8,25,45,78,-33,47
Sky Bet League 2 2015/16,Morecambe,46,12,10,24,69,91,-22,46
Sky Bet League 2 2015/16,Newport County AFC,46,10,13,23,43,64,-21,43
Sky Bet League 2 2015/16,Dagenham & Redbridge,46,8,10,28,46,81,-35,34
Sky Bet League 2 2015/16,York City,46,7,13,26,51,87,-36,34
Sky Bet League Two 2016/17,Portsmouth,46,26,9,11,79,40,39,87
Sky Bet League Two 2016/17,Plymouth Argyle,46,26,9,11,71,46,25,87
Sky Bet League Two 2016/17,Doncaster Rovers,46,25,10,11,85,55,30,85
Sky Bet League Two 2016/17,Luton Town,46,20,17,9,70,43,27,77
Sky Bet League Two 2016/17,Exeter City,46,21,8,17,75,56,19,71
Sky Bet League Two 2016/17,Carlisle United,46,18,17,11,69,68,1,71
Sky Bet League Two 2016/17,Blackpool,46,18,16,12,69,46,23,70
Sky Bet League Two 2016/17,Colchester United,46,19,12,15,67,57,10,69
Sky Bet League Two 2016/17,Wycombe Wanderers,46,19,12,15,58,53,5,69
Sky Bet League Two 2016/17,Stevenage,46,20,7,19,67,63,4,67
Sky Bet League Two 2016/17,Cambridge United,46,19,9,18,58,50,8,66
Sky Bet League Two 2016/17,Mansfield Town,46,17,15,14,54,50,4,66
Sky Bet League Two 2016/17,Accrington Stanley,46,17,14,15,59,56,3,65
Sky Bet League Two 2016/17,Grimsby Town,46,17,11,18,59,63,-4,62
Sky Bet League Two 2016/17,Barnet,46,14,15,17,57,64,-7,57
Sky Bet League Two 2016/17,Notts County,46,16,8,22,54,76,-22,56
Sky Bet League Two 2016/17,Crewe Alexandra,46,14,13,19,58,67,-9,55
Sky Bet League Two 2016/17,Morecambe,46,14,10,22,53,73,-20,52
Sky Bet League Two 2016/17,Crawley Town,46,13,12,21,53,71,-18,51
Sky Bet League Two 2016/17,Yeovil Town,46,11,17,18,49,64,-15,50
Sky Bet League Two 2016/17,Cheltenham Town,46,12,14,20,49,69,-20,50
Sky Bet League Two 2016/17,Newport County AFC,46,12,12,22,51,73,-22,48
Sky Bet League Two 2016/17,Hartlepool United,46,11,13,22,54,75,-21,46
Sky Bet League Two 2016/17,Leyton Orient,46,10,6,30,47,87,-40,36
Sky Bet League Two 2017/18,Accrington Stanley,46,29,6,11,76,46,30,93
Sky Bet League Two 2017/18,Luton Town,46,25,13,8,94,46,48,88
Sky Bet League Two 2017/18,Wycombe Wanderers,46,24,12,10,79,60,19,84
Sky Bet League Two 2017/18,Exeter City,46,24,8,14,64,54,10,80
Sky Bet League Two 2017/18,Notts County,46,21,14,11,71,48,23,77
Sky Bet League Two 2017/18,Coventry City,46,22,9,15,64,47,17,75
Sky Bet League Two 2017/18,Lincoln City,46,20,15,11,64,48,16,75
Sky Bet League Two 2017/18,Mansfield Town,46,18,18,10,67,52,15,72
Sky Bet League Two 2017/18,Swindon Town,46,20,8,18,67,65,2,68
Sky Bet League Two 2017/18,Carlisle United,46,17,16,13,62,54,8,67
Sky Bet League Two 2017/18,Newport County AFC,46,16,16,14,56,58,-2,64
Sky Bet League Two 2017/18,Cambridge United,46,17,13,16,56,60,-4,64
Sky Bet League Two 2017/18,Colchester United,46,16,14,16,53,52,1,62
Sky Bet League Two 2017/18,Crawley Town,46,16,11,19,58,66,-8,59
Sky Bet League Two 2017/18,Crewe Alexandra,46,17,5,24,62,75,-13,56
Sky Bet League Two 2017/18,Stevenage,46,14,13,19,60,65,-5,55
Sky Bet League Two 2017/18,Cheltenham Town,46,13,12,21,67,73,-6,51
Sky Bet League Two 2017/18,Grimsby Town,46,13,12,21,42,66,-24,51
Sky Bet League Two 2017/18,Yeovil Town,46,12,12,22,59,75,-16,48
Sky Bet League Two 2017/18,Port Vale,46,11,14,21,49,67,-18,47
Sky Bet League Two 2017/18,Forest Green Rovers,46,13,8,25,54,77,-23,47
Sky Bet League Two 2017/18,Morecambe,46,9,19,18,41,56,-15,46
Sky Bet League Two 2017/18,Barnet,46,12,10,24,46,65,-19,46
Sky Bet League Two 2017/18,Chesterfield,46,10,8,28,47,83,-36,38
Sky Bet League Two 2018/19,Lincoln City,46,23,16,7,73,43,30,85
Sky Bet League Two 2018/19,Bury,46,22,13,11,82,56,26,79
Sky Bet League Two 2018/19,Milton Keynes Dons,46,23,10,13,71,49,22,79
Sky Bet League Two 2018/19,Mansfield Town,46,20,16,10,69,41,28,76
Sky Bet League Two 2018/19,Forest Green Rovers,46,20,14,12,68,47,21,74
Sky Bet League Two 2018/19,Tranmere Rovers,46,20,13,13,63,50,13,73
Sky Bet League Two 2018/19,Newport County AFC,46,20,11,15,59,59,0,71
Sky Bet League Two 2018/19,Colchester United,46,20,10,16,65,53,12,70
Sky Bet League Two 2018/19,Exeter City,46,19,13,14,60,49,11,70
Sky Bet League Two 2018/19,Stevenage,46,20,10,16,59,55,4,70
Sky Bet League Two 2018/19,Carlisle United,46,20,8,18,67,62,5,68
Sky Bet League Two 2018/19,Crewe Alexandra,46,19,8,19,60,59,1,65
Sky Bet League Two 2018/19,Swindon Town,46,16,16,14,59,56,3,64
Sky Bet League Two 2018/19,Oldham Athletic,46,16,14,16,67,60,7,62
Sky Bet League Two 2018/19,Northampton Town,46,14,19,13,64,63,1,61
Sky Bet League Two 2018/19,Cheltenham Town,46,15,12,19,57,68,-11,57
Sky Bet League Two 2018/19,Grimsby Town,46,16,8,22,45,56,-11,56
Sky Bet League Two 2018/19,Morecambe,46,14,12,20,54,70,-16,54
Sky Bet League Two 2018/19,Crawley Town,46,15,8,23,51,68,-17,53
Sky Bet League Two 2018/19,Port Vale,46,12,13,21,39,55,-16,49
Sky Bet League Two 2018/19,Cambridge United,46,12,11,23,40,66,-26,47
Sky Bet League Two 2018/19,Macclesfield Town,46,10,14,22,48,74,-26,44
Sky Bet League Two 2018/19,Notts County,46,9,14,23,48,84,-36,41
Sky Bet League Two 2018/19,Yeovil Town,46,9,13,24,41,66,-25,40
Sky Bet League Two 2019/20,Swindon Town,36,21,6,9,62,39,23,69
Sky Bet League Two 2019/20,Crewe Alexandra,37,20,9,8,67,43,24,69
Sky Bet League Two 2019/20,Plymouth Argyle,37,20,8,9,61,39,22,68
Sky Bet League Two 2019/20,Cheltenham Town,36,17,13,6,52,27,25,64
Sky Bet League Two 2019/20,Exeter City,37,18,11,8,53,43,10,65
Sky Bet League Two 2019/20,Colchester United,37,15,13,9,52,37,15,58
Sky Bet League Two 2019/20,Northampton Town,37,17,7,13,54,40,14,58
Sky Bet League Two 2019/20,Port Vale,37,14,15,8,50,44,6,57
Sky Bet League Two 2019/20,Bradford City,37,14,12,11,44,40,4,54
Sky Bet League Two 2019/20,Forest Green Rovers,36,13,10,13,43,40,3,49
Sky Bet League Two 2019/20,Salford City,37,13,11,13,49,46,3,50
Sky Bet League Two 2019/20,Walsall,36,13,8,15,40,49,-9,47
Sky Bet League Two 2019/20,Crawley Town,37,11,15,11,51,47,4,48
Sky Bet League Two 2019/20,Newport County AFC,36,12,10,14,32,39,-7,46
Sky Bet League Two 2019/20,Grimsby Town,37,12,11,14,45,51,-6,47
Sky Bet League Two 2019/20,Cambridge United,37,12,9,16,40,48,-8,45
Sky Bet League Two 2019/20,Leyton Orient,36,10,12,14,47,55,-8,42
Sky Bet League Two 2019/20,Carlisle United,37,10,12,15,39,56,-17,42
Sky Bet League Two 2019/20,Oldham Athletic,37,9,14,14,44,57,-13,41
Sky Bet League Two 2019/20,Scunthorpe United,37,10,10,17,44,56,-12,40
Sky Bet League Two 2019/20,Mansfield Town,36,9,11,16,48,55,-7,38
Sky Bet League Two 2019/20,Morecambe,37,7,11,19,35,60,-25,32
Sky Bet League Two 2019/20,Macclesfield Town *,37,7,15,15,32,47,-15,23
Sky Bet League Two 2019/20,Stevenage,36,3,13,20,24,50,-26,22
Sky Bet League Two 2020/21,Newport County AFC,11,8,1,2,19,10,9,25
Sky Bet League Two 2020/21,Cambridge United,11,7,2,2,24,8,16,23
Sky Bet League Two 2020/21,Forest Green Rovers,11,6,3,2,15,9,6,21
Sky Bet League Two 2020/21,Exeter City,11,5,5,1,17,12,5,20
Sky Bet League Two 2020/21,Carlisle United,11,6,2,3,15,12,3,20
Sky Bet League Two 2020/21,Cheltenham Town,11,6,1,4,16,10,6,19
Sky Bet League Two 2020/21,Port Vale,10,6,1,3,12,7,5,19
Sky Bet League Two 2020/21,Crawley Town,11,5,2,4,17,12,5,17
Sky Bet League Two 2020/21,Morecambe,11,5,2,4,14,21,-7,17
Sky Bet League Two 2020/21,Salford City,10,4,4,2,16,8,8,16
Sky Bet League Two 2020/21,Colchester United,10,4,4,2,16,12,4,16
Sky Bet League Two 2020/21,Walsall,11,3,7,1,12,11,1,16
Sky Bet League Two 2020/21,Leyton Orient,11,4,3,4,16,13,3,15
Sky Bet League Two 2020/21,Harrogate Town,11,4,3,4,13,10,3,15
Sky Bet League Two 2020/21,Bradford City,10,3,3,4,11,11,0,12
Sky Bet League Two 2020/21,Grimsby Town,10,3,3,4,9,12,-3,12
Sky Bet League Two 2020/21,Tranmere Rovers,11,3,3,5,7,12,-5,12
Sky Bet League Two 2020/21,Barrow,11,2,5,4,14,15,-1,11
Sky Bet League Two 2020/21,Oldham Athletic,11,3,2,6,15,21,-6,11
Sky Bet League Two 2020/21,Bolton Wanderers,11,2,4,5,9,17,-8,10
Sky Bet League Two 2020/21,Stevenage,11,1,4,6,6,11,-5,7
Sky Bet League Two 2020/21,Mansfield Town,11,0,7,4,10,16,-6,7
Sky Bet League Two 2020/21,Scunthorpe United,8,1,1,6,4,17,-13,4
Sky Bet League Two 2020/21,Southend United,11,0,2,9,5,25,-20,2
French Ligue 1 2009/10,Marseille,38,23,9,6,69,36,33,78
French Ligue 1 2009/10,Lyon,38,20,12,6,64,38,26,72
French Ligue 1 2009/10,Auxerre,38,20,11,7,42,29,13,71
French Ligue 1 2009/10,Lille,38,21,7,10,72,40,32,70
French Ligue 1 2009/10,Montpellier,38,20,9,9,50,40,10,69
French Ligue 1 2009/10,Bordeaux,38,19,7,12,58,40,18,64
French Ligue 1 2009/10,Lorient,38,16,10,12,54,42,12,58
French Ligue 1 2009/10,Monaco,38,15,10,13,39,45,-6,55
French Ligue 1 2009/10,Rennes,38,14,11,13,52,41,11,53
French Ligue 1 2009/10,Valenciennes,38,14,10,14,50,50,0,52
French Ligue 1 2009/10,RC Lens,38,12,12,14,40,44,-4,48
French Ligue 1 2009/10,Nancy,38,13,9,16,46,53,-7,48
French Ligue 1 2009/10,Paris Saint-Germain,38,12,11,15,50,46,4,47
French Ligue 1 2009/10,Toulouse,38,12,11,15,36,36,0,47
French Ligue 1 2009/10,Nice,38,11,11,16,41,57,-16,44
French Ligue 1 2009/10,Sochaux,38,11,8,19,28,55,-27,41
French Ligue 1 2009/10,St Etienne,38,10,10,18,27,45,-18,40
French Ligue 1 2009/10,Le Mans,38,8,8,22,36,59,-23,32
French Ligue 1 2009/10,Boulogne,38,7,10,21,31,62,-31,31
French Ligue 1 2009/10,Grenoble,38,5,8,25,31,61,-30,23
French Ligue 1 2010/11,Lille,38,21,13,4,68,36,32,76
French Ligue 1 2010/11,Marseille,38,18,14,6,62,39,23,68
French Ligue 1 2010/11,Lyon,38,17,13,8,61,40,21,64
French Ligue 1 2010/11,Paris Saint-Germain,38,15,15,8,56,41,15,60
French Ligue 1 2010/11,Sochaux,38,17,7,14,60,43,17,58
French Ligue 1 2010/11,Rennes,38,15,11,12,38,35,3,56
French Ligue 1 2010/11,Bordeaux,38,12,15,11,43,42,1,51
French Ligue 1 2010/11,Toulouse,38,14,8,16,38,36,2,50
French Ligue 1 2010/11,Auxerre,38,10,19,9,45,41,4,49
French Ligue 1 2010/11,St Etienne,38,12,13,13,46,47,-1,49
French Ligue 1 2010/11,Lorient,38,12,13,13,46,48,-2,49
French Ligue 1 2010/11,Valenciennes,38,10,18,10,45,41,4,48
French Ligue 1 2010/11,Nancy,38,13,9,16,43,48,-5,48
French Ligue 1 2010/11,Montpellier,38,12,11,15,32,43,-11,47
French Ligue 1 2010/11,Caen,38,11,13,14,46,51,-5,46
French Ligue 1 2010/11,Brest,38,11,13,14,36,43,-7,46
French Ligue 1 2010/11,Nice,38,11,13,14,33,48,-15,46
French Ligue 1 2010/11,Monaco,38,9,17,12,36,40,-4,44
French Ligue 1 2010/11,RC Lens,38,7,14,17,35,58,-23,35
French Ligue 1 2010/11,Arles,38,3,11,24,21,70,-49,20
French Ligue 1 2011/12,Montpellier,38,25,7,6,68,34,34,82
French Ligue 1 2011/12,Paris Saint-Germain,38,23,10,5,75,41,34,79
French Ligue 1 2011/12,Lille,38,21,11,6,72,39,33,74
French Ligue 1 2011/12,Lyon,38,19,7,12,64,51,13,64
French Ligue 1 2011/12,Bordeaux,38,16,13,9,53,41,12,61
French Ligue 1 2011/12,Rennes,38,17,9,12,53,44,9,60
French Ligue 1 2011/12,St Etienne,38,16,9,13,49,45,4,57
French Ligue 1 2011/12,Toulouse,38,15,11,12,37,34,3,56
French Ligue 1 2011/12,Evian Thonon Gaillar,38,13,11,14,54,55,-1,50
French Ligue 1 2011/12,Marseille,38,12,12,14,45,41,4,48
French Ligue 1 2011/12,Nancy,38,11,12,15,38,48,-10,45
French Ligue 1 2011/12,Valenciennes,38,12,7,19,40,50,-10,43
French Ligue 1 2011/12,Nice,38,10,12,16,39,46,-7,42
French Ligue 1 2011/12,Sochaux,38,11,9,18,40,60,-20,42
French Ligue 1 2011/12,Brest,38,8,17,13,31,38,-7,41
French Ligue 1 2011/12,AC Ajaccio,38,9,14,15,40,61,-21,41
French Ligue 1 2011/12,Lorient,38,9,12,17,35,49,-14,39
French Ligue 1 2011/12,Caen,38,9,11,18,39,59,-20,38
French Ligue 1 2011/12,Dijon,38,9,9,20,38,63,-25,36
French Ligue 1 2011/12,Auxerre,38,7,13,18,46,57,-11,34
French Ligue 1 2012/13,Paris Saint-Germain,38,25,8,5,69,23,46,83
French Ligue 1 2012/13,Marseille,38,21,8,9,42,36,6,71
French Ligue 1 2012/13,Lyon,38,19,10,9,61,38,23,67
French Ligue 1 2012/13,Nice,38,18,10,10,57,46,11,64
French Ligue 1 2012/13,St Etienne,38,16,15,7,60,32,28,63
French Ligue 1 2012/13,Lille,38,16,14,8,59,40,19,62
French Ligue 1 2012/13,Bordeaux,38,13,16,9,40,34,6,55
French Ligue 1 2012/13,Lorient,38,14,11,13,57,58,-1,53
French Ligue 1 2012/13,Montpellier,38,15,7,16,54,51,3,52
French Ligue 1 2012/13,Toulouse,38,13,12,13,49,47,2,51
French Ligue 1 2012/13,Valenciennes,38,12,12,14,49,53,-4,48
French Ligue 1 2012/13,Bastia,38,13,8,17,50,66,-16,47
French Ligue 1 2012/13,Rennes,38,13,7,18,48,59,-11,46
French Ligue 1 2012/13,Reims,38,10,13,15,33,42,-9,43
French Ligue 1 2012/13,Sochaux,38,10,11,17,41,57,-16,41
French Ligue 1 2012/13,Evian Thonon Gaillar,38,10,10,18,46,53,-7,40
French Ligue 1 2012/13,AC Ajaccio *,38,9,15,14,39,51,-12,40
French Ligue 1 2012/13,Nancy,38,9,11,18,38,58,-20,38
French Ligue 1 2012/13,Troyes,38,8,13,17,43,61,-18,37
French Ligue 1 2012/13,Brest,38,8,5,25,32,62,-30,29
French Ligue 1 2013/14,Paris Saint-Germain,38,27,8,3,84,23,61,89
French Ligue 1 2013/14,Monaco,38,23,11,4,63,31,32,80
French Ligue 1 2013/14,Lille,38,20,11,7,46,26,20,71
French Ligue 1 2013/14,St Etienne,38,20,9,9,56,34,22,69
French Ligue 1 2013/14,Lyon,38,17,10,11,56,44,12,61
French Ligue 1 2013/14,Marseille,38,16,12,10,53,40,13,60
French Ligue 1 2013/14,Bordeaux,38,13,14,11,49,43,6,53
French Ligue 1 2013/14,Lorient,38,13,10,15,48,53,-5,49
French Ligue 1 2013/14,Toulouse,38,12,13,13,46,53,-7,49
French Ligue 1 2013/14,Bastia,38,12,11,15,42,56,-14,49
French Ligue 1 2013/14,Reims,38,12,12,14,44,55,-11,48
French Ligue 1 2013/14,Rennes,38,11,13,14,47,45,2,46
French Ligue 1 2013/14,Nantes,38,12,11,15,38,43,-5,46
French Ligue 1 2013/14,Evian Thonon Gaillar,38,11,11,16,39,51,-12,44
French Ligue 1 2013/14,Montpellier,38,8,18,12,45,53,-8,42
French Ligue 1 2013/14,Guingamp,38,11,9,18,34,42,-8,42
French Ligue 1 2013/14,Nice,38,12,6,20,30,45,-15,42
French Ligue 1 2013/14,Sochaux,38,10,10,18,37,61,-24,40
French Ligue 1 2013/14,Valenciennes,38,7,8,23,37,65,-28,29
French Ligue 1 2013/14,AC Ajaccio,38,4,11,23,37,72,-35,23
French Ligue 1 2014/15,Paris Saint-Germain,38,24,11,3,83,36,47,83
French Ligue 1 2014/15,Lyon,38,22,9,7,72,33,39,75
French Ligue 1 2014/15,Monaco,38,20,11,7,51,26,25,71
French Ligue 1 2014/15,Marseille,38,21,6,11,76,42,34,69
French Ligue 1 2014/15,St Etienne,38,19,12,7,51,30,21,69
French Ligue 1 2014/15,Bordeaux,38,17,12,9,47,44,3,63
French Ligue 1 2014/15,Montpellier,38,16,8,14,46,39,7,56
French Ligue 1 2014/15,Lille,38,16,8,14,43,42,1,56
French Ligue 1 2014/15,Rennes,38,13,11,14,35,42,-7,50
French Ligue 1 2014/15,Guingamp,38,15,4,19,41,55,-14,49
French Ligue 1 2014/15,Nice,38,13,9,16,44,53,-9,48
French Ligue 1 2014/15,Bastia,38,12,11,15,37,46,-9,47
French Ligue 1 2014/15,Caen,38,12,10,16,54,55,-1,46
French Ligue 1 2014/15,Nantes,38,11,12,15,29,40,-11,45
French Ligue 1 2014/15,Reims,38,12,8,18,47,66,-19,44
French Ligue 1 2014/15,Lorient,38,12,7,19,44,50,-6,43
French Ligue 1 2014/15,Toulouse,38,12,6,20,43,64,-21,42
French Ligue 1 2014/15,Evian Thonon Gaillar,38,11,4,23,41,62,-21,37
French Ligue 1 2014/15,Metz,38,7,9,22,31,61,-30,30
French Ligue 1 2014/15,RC Lens,38,7,8,23,32,61,-29,29
French Ligue 1 2015/16,Paris Saint-Germain,38,30,6,2,102,19,83,96
French Ligue 1 2015/16,Lyon,38,19,8,11,67,43,24,65
French Ligue 1 2015/16,Monaco,38,17,14,7,57,50,7,65
French Ligue 1 2015/16,Nice,38,18,9,11,58,41,17,63
French Ligue 1 2015/16,Lille,38,15,15,8,39,27,12,60
French Ligue 1 2015/16,St Etienne,38,17,7,14,42,37,5,58
French Ligue 1 2015/16,Caen,38,16,6,16,39,52,-13,54
French Ligue 1 2015/16,Rennes,38,13,13,12,52,54,-2,52
French Ligue 1 2015/16,Angers,38,13,11,14,40,38,2,50
French Ligue 1 2015/16,Bastia,38,14,8,16,36,42,-6,50
French Ligue 1 2015/16,Bordeaux,38,12,14,12,50,57,-7,50
French Ligue 1 2015/16,Montpellier,38,14,7,17,49,47,2,49
French Ligue 1 2015/16,Marseille,38,10,18,10,48,42,6,48
French Ligue 1 2015/16,Nantes,38,12,12,14,33,44,-11,48
French Ligue 1 2015/16,Lorient,38,11,13,14,47,58,-11,46
French Ligue 1 2015/16,Guingamp,38,11,11,16,47,56,-9,44
French Ligue 1 2015/16,Toulouse,38,9,13,16,45,55,-10,40
French Ligue 1 2015/16,Reims,38,10,9,19,44,57,-13,39
French Ligue 1 2015/16,Gazelec Ajaccio,38,8,13,17,37,58,-21,37
French Ligue 1 2015/16,Troyes,38,3,9,26,28,83,-55,18
French Ligue 1 2016/17,Monaco,38,30,5,3,107,31,76,95
French Ligue 1 2016/17,Paris Saint-Germain,38,27,6,5,83,27,56,87
French Ligue 1 2016/17,Nice,38,22,12,4,63,36,27,78
French Ligue 1 2016/17,Lyon,38,21,4,13,77,48,29,67
French Ligue 1 2016/17,Marseille,38,17,11,10,57,41,16,62
French Ligue 1 2016/17,Bordeaux,38,15,14,9,53,43,10,59
French Ligue 1 2016/17,Nantes,38,14,9,15,40,54,-14,51
French Ligue 1 2016/17,St Etienne,38,12,14,12,41,42,-1,50
French Ligue 1 2016/17,Rennes,38,12,14,12,36,42,-6,50
French Ligue 1 2016/17,Guingamp,38,14,8,16,46,53,-7,50
French Ligue 1 2016/17,Lille,38,13,7,18,40,47,-7,46
French Ligue 1 2016/17,Angers,38,13,7,18,40,49,-9,46
French Ligue 1 2016/17,Toulouse,38,10,14,14,37,41,-4,44
French Ligue 1 2016/17,Metz,38,11,10,17,39,72,-33,43
French Ligue 1 2016/17,Montpellier,38,10,9,19,48,66,-18,39
French Ligue 1 2016/17,Dijon,38,8,13,17,46,58,-12,37
French Ligue 1 2016/17,Caen,38,10,7,21,36,65,-29,37
French Ligue 1 2016/17,Lorient,38,10,6,22,44,70,-26,36
French Ligue 1 2016/17,Nancy,38,9,8,21,29,52,-23,35
French Ligue 1 2016/17,Bastia,38,8,10,20,29,54,-25,34
French Ligue 1 2017/18,Paris Saint-Germain,38,29,6,3,108,29,79,93
French Ligue 1 2017/18,Monaco,38,24,8,6,85,45,40,80
French Ligue 1 2017/18,Lyon,38,23,9,6,87,43,44,78
French Ligue 1 2017/18,Marseille,38,22,11,5,80,47,33,77
French Ligue 1 2017/18,Rennes,38,16,10,12,50,44,6,58
French Ligue 1 2017/18,Bordeaux,38,16,7,15,53,48,5,55
French Ligue 1 2017/18,St Etienne,38,15,10,13,47,50,-3,55
French Ligue 1 2017/18,Nice,38,15,9,14,53,52,1,54
French Ligue 1 2017/18,Nantes,38,14,10,14,36,41,-5,52
French Ligue 1 2017/18,Montpellier,38,11,18,9,36,33,3,51
French Ligue 1 2017/18,Dijon,38,13,9,16,55,73,-18,48
French Ligue 1 2017/18,Guingamp,38,12,11,15,48,59,-11,47
French Ligue 1 2017/18,Amiens,38,12,9,17,37,42,-5,45
French Ligue 1 2017/18,Angers,38,9,14,15,42,52,-10,41
French Ligue 1 2017/18,Strasbourg,38,9,11,18,44,67,-23,38
French Ligue 1 2017/18,Caen,38,10,8,20,27,52,-25,38
French Ligue 1 2017/18,Lille,38,10,8,20,41,67,-26,38
French Ligue 1 2017/18,Toulouse,38,9,10,19,38,54,-16,37
French Ligue 1 2017/18,Troyes,38,9,6,23,32,59,-27,33
French Ligue 1 2017/18,Metz,38,6,8,24,34,76,-42,26
French Ligue 1 2018/19,Paris Saint-Germain,38,29,4,5,105,35,70,91
French Ligue 1 2018/19,Lille,38,22,9,7,68,33,35,75
French Ligue 1 2018/19,Lyon,38,21,9,8,70,47,23,72
French Ligue 1 2018/19,St Etienne,38,19,9,10,59,41,18,66
French Ligue 1 2018/19,Marseille,38,18,7,13,60,52,8,61
French Ligue 1 2018/19,Montpellier,38,15,14,9,53,42,11,59
French Ligue 1 2018/19,Nice,38,15,11,12,30,35,-5,56
French Ligue 1 2018/19,Reims,38,13,16,9,39,42,-3,55
French Ligue 1 2018/19,Nimes,38,15,8,15,57,58,-1,53
French Ligue 1 2018/19,Rennes,38,13,13,12,55,52,3,52
French Ligue 1 2018/19,Strasbourg,38,11,16,11,58,48,10,49
French Ligue 1 2018/19,Nantes,38,13,9,16,48,48,0,48
French Ligue 1 2018/19,Angers,38,10,16,12,44,49,-5,46
French Ligue 1 2018/19,Bordeaux,38,10,11,17,34,42,-8,41
French Ligue 1 2018/19,Amiens,38,9,11,18,31,52,-21,38
French Ligue 1 2018/19,Toulouse,38,8,14,16,35,57,-22,38
French Ligue 1 2018/19,Monaco,38,8,12,18,38,57,-19,36
French Ligue 1 2018/19,Dijon,38,9,7,22,31,60,-29,34
French Ligue 1 2018/19,Caen,38,7,12,19,29,54,-25,33
French Ligue 1 2018/19,Guingamp,38,5,12,21,28,68,-40,27
French Ligue 1 2019/20,Paris Saint-Germain,27,22,2,3,75,24,51,68
French Ligue 1 2019/20,Marseille,28,16,8,4,41,29,12,56
French Ligue 1 2019/20,Rennes,28,15,5,8,38,24,14,50
French Ligue 1 2019/20,Lille,28,15,4,9,35,27,8,49
French Ligue 1 2019/20,Nice,28,11,8,9,41,38,3,41
French Ligue 1 2019/20,Reims,28,10,11,7,26,21,5,41
French Ligue 1 2019/20,Lyon,28,11,7,10,42,27,15,40
French Ligue 1 2019/20,Montpellier,28,11,7,10,35,34,1,40
French Ligue 1 2019/20,Monaco,28,11,7,10,44,44,0,40
French Ligue 1 2019/20,Strasbourg,27,11,5,11,32,32,0,38
French Ligue 1 2019/20,Angers,28,11,6,11,28,33,-5,39
French Ligue 1 2019/20,Bordeaux,28,9,10,9,40,34,6,37
French Ligue 1 2019/20,Nantes,28,11,4,13,28,31,-3,37
French Ligue 1 2019/20,Brest,28,8,10,10,34,37,-3,34
French Ligue 1 2019/20,Metz,28,8,10,10,27,35,-8,34
French Ligue 1 2019/20,Dijon,28,7,9,12,27,37,-10,30
French Ligue 1 2019/20,St Etienne,28,8,6,14,29,45,-16,30
French Ligue 1 2019/20,Nimes,28,7,6,15,29,44,-15,27
French Ligue 1 2019/20,Amiens,28,4,11,13,31,50,-19,23
French Ligue 1 2019/20,Toulouse,28,3,4,21,22,58,-36,13
French Ligue 1 2020/21,Paris Saint-Germain,9,7,0,2,23,3,20,21
French Ligue 1 2020/21,Lille,9,5,4,0,15,4,11,19
French Ligue 1 2020/21,Rennes,9,5,3,1,18,11,7,18
French Ligue 1 2020/21,Nice,9,5,2,2,14,10,4,17
French Ligue 1 2020/21,Marseille,8,4,3,1,11,8,3,15
French Ligue 1 2020/21,Lyon,9,3,5,1,15,9,6,14
French Ligue 1 2020/21,Metz,9,4,2,3,10,7,3,14
French Ligue 1 2020/21,Monaco,9,4,2,3,15,13,2,14
French Ligue 1 2020/21,Montpellier,9,4,2,3,14,13,1,14
French Ligue 1 2020/21,RC Lens,7,4,1,2,10,10,0,13
French Ligue 1 2020/21,Angers,9,4,1,4,10,19,-9,13
French Ligue 1 2020/21,Bordeaux,9,3,3,3,9,9,0,12
French Ligue 1 2020/21,St Etienne,9,3,1,5,9,13,-4,10
French Ligue 1 2020/21,Brest,9,3,0,6,12,20,-8,9
French Ligue 1 2020/21,Reims,9,2,2,5,12,14,-2,8
French Ligue 1 2020/21,Lorient,9,2,2,5,12,15,-3,8
French Ligue 1 2020/21,Nantes,8,2,2,4,9,13,-4,8
French Ligue 1 2020/21,Nimes,9,2,2,5,9,14,-5,8
French Ligue 1 2020/21,Strasbourg,9,2,0,7,10,18,-8,6
French Ligue 1 2020/21,Dijon,9,0,3,6,4,18,-14,3
American MLS League - Eastern Conference 2010/11,New York Red Bulls,30,15,6,9,38,29,9,51
American MLS League - Eastern Conference 2010/11,Columbus Crew,30,14,8,8,40,34,6,50
American MLS League - Eastern Conference 2010/11,Sporting Kansas City,30,11,6,13,36,35,1,39
American MLS League - Eastern Conference 2010/11,Chicago Fire,30,9,9,12,37,38,-1,36
American MLS League - Eastern Conference 2010/11,Toronto FC,30,9,8,13,33,41,-8,35
American MLS League - Eastern Conference 2010/11,New England Revolution,30,9,5,16,32,50,-18,32
American MLS League - Eastern Conference 2010/11,Philadelphia Union,30,8,7,15,35,49,-14,31
American MLS League - Eastern Conference 2010/11,D.C. United,30,6,4,20,21,47,-26,22
American MLS League - Western Conference 2010/11,Los Angeles Galaxy,30,18,5,7,44,26,18,59
American MLS League - Western Conference 2010/11,Real Salt Lake,30,15,11,4,45,20,25,56
American MLS League - Western Conference 2010/11,FC Dallas,30,12,14,4,42,28,14,50
American MLS League - Western Conference 2010/11,Seattle Sounders FC,30,14,6,10,39,35,4,48
American MLS League - Western Conference 2010/11,Colorado Rapids,30,12,10,8,44,32,12,46
American MLS League - Western Conference 2010/11,San Jose Earthquakes,30,13,7,10,34,33,1,46
American MLS League - Western Conference 2010/11,Houston Dynamo,30,9,6,15,40,49,-9,33
American MLS League - Western Conference 2010/11,Chivas USA,30,8,4,18,31,45,-14,28
American MLS League - Eastern Conference 2011/12,Sporting Kansas City,34,13,12,9,50,40,10,51
American MLS League - Eastern Conference 2011/12,Philadelphia Union,34,11,15,8,44,36,8,48
American MLS League - Eastern Conference 2011/12,Columbus Crew,34,13,8,13,43,44,-1,47
American MLS League - Eastern Conference 2011/12,New York Red Bulls,34,10,16,8,50,44,6,46
American MLS League - Eastern Conference 2011/12,Houston Dynamo,33,11,13,9,42,40,2,46
American MLS League - Eastern Conference 2011/12,Chicago Fire,34,9,16,9,46,45,1,43
American MLS League - Eastern Conference 2011/12,D.C. United,34,9,12,13,49,52,-3,39
American MLS League - Eastern Conference 2011/12,Toronto FC,34,6,15,13,36,59,-23,33
American MLS League - Eastern Conference 2011/12,New England Revolution,34,5,13,16,38,58,-20,28
American MLS League - Western Conference 2011/12,Los Angeles Galaxy,33,19,10,4,47,25,22,67
American MLS League - Western Conference 2011/12,Seattle Sounders FC,34,18,9,7,56,37,19,63
American MLS League - Western Conference 2011/12,Real Salt Lake,34,15,8,11,44,36,8,53
American MLS League - Western Conference 2011/12,FC Dallas,34,15,7,12,42,39,3,52
American MLS League - Western Conference 2011/12,Colorado Rapids,34,12,13,9,44,41,3,49
American MLS League - Western Conference 2011/12,Portland Timbers,34,11,9,14,40,48,-8,42
American MLS League - Western Conference 2011/12,San Jose Earthquakes,34,8,14,12,40,45,-5,38
American MLS League - Western Conference 2011/12,Chivas USA,34,8,12,14,41,43,-2,36
American MLS League - Western Conference 2011/12,Vancouver Whitecaps,34,6,10,18,35,55,-20,28
American MLS League - Eastern Conference 2012/13,Sporting Kansas City,34,18,9,7,42,27,15,63
American MLS League - Eastern Conference 2012/13,D.C. United,33,17,6,10,52,42,10,57
American MLS League - Eastern Conference 2012/13,Chicago Fire,33,17,5,11,45,40,5,56
American MLS League - Eastern Conference 2012/13,New York Red Bulls,33,15,9,9,54,46,8,54
American MLS League - Eastern Conference 2012/13,Houston Dynamo,33,14,11,8,48,39,9,53
American MLS League - Eastern Conference 2012/13,Columbus Crew,33,14,7,12,42,43,-1,49
American MLS League - Eastern Conference 2012/13,Montreal Impact,33,12,6,15,45,50,-5,42
American MLS League - Eastern Conference 2012/13,Philadelphia Union,33,10,6,17,37,42,-5,36
American MLS League - Eastern Conference 2012/13,New England Revolution,33,8,8,17,38,44,-6,32
American MLS League - Eastern Conference 2012/13,Toronto FC,33,5,8,20,35,60,-25,23
American MLS League - Eastern Conference 2013/14,D.C. United,34,17,8,9,52,37,15,59
American MLS League - Eastern Conference 2013/14,New England Revolution,34,17,4,13,51,46,5,55
American MLS League - Eastern Conference 2013/14,Columbus Crew,34,14,10,10,52,42,10,52
American MLS League - Eastern Conference 2013/14,New York Red Bulls,34,13,11,10,55,50,5,50
American MLS League - Eastern Conference 2013/14,Sporting Kansas City,34,14,7,13,48,41,7,49
American MLS League - Eastern Conference 2013/14,Philadelphia Union,34,10,12,12,51,51,0,42
American MLS League - Eastern Conference 2013/14,Toronto FC,34,11,8,15,44,54,-10,41
American MLS League - Eastern Conference 2013/14,Houston Dynamo,34,11,6,17,39,58,-19,39
American MLS League - Eastern Conference 2013/14,Chicago Fire,34,6,18,10,41,51,-10,36
American MLS League - Eastern Conference 2013/14,Montreal Impact,34,6,10,18,38,58,-20,28
American MLS League - Western Conference 2013/14,Seattle Sounders FC,34,20,4,10,65,50,15,64
American MLS League - Western Conference 2013/14,Los Angeles Galaxy,34,17,10,7,69,37,32,61
American MLS League - Western Conference 2013/14,Real Salt Lake,34,15,11,8,54,39,15,56
American MLS League - Western Conference 2013/14,FC Dallas,34,16,6,12,55,45,10,54
American MLS League - Western Conference 2013/14,Vancouver Whitecaps,34,12,14,8,42,40,2,50
American MLS League - Western Conference 2013/14,Portland Timbers,34,12,13,9,61,52,9,49
American MLS League - Western Conference 2013/14,Chivas USA,34,9,6,19,29,61,-32,33
American MLS League - Western Conference 2013/14,Colorado Rapids,34,8,8,18,43,62,-19,32
American MLS League - Western Conference 2013/14,San Jose Earthquakes,34,6,12,16,35,50,-15,30
American MLS League - Eastern Conference 2014/15,D.C. United,17,8,4,5,20,16,4,28
American MLS League - Eastern Conference 2014/15,New England Revolution,16,6,6,4,22,20,2,24
American MLS League - Eastern Conference 2014/15,Orlando City SC,15,5,5,5,20,19,1,20
American MLS League - Eastern Conference 2014/15,Toronto FC,12,6,1,5,19,16,3,19
American MLS League - Eastern Conference 2014/15,New York Red Bulls,13,4,5,4,17,17,0,17
American MLS League - Eastern Conference 2014/15,Columbus Crew,15,4,5,6,21,22,-1,17
American MLS League - Eastern Conference 2014/15,Philadelphia Union,16,4,3,9,18,25,-7,15
American MLS League - Eastern Conference 2014/15,Montreal Impact,11,4,2,5,14,18,-4,14
American MLS League - Eastern Conference 2014/15,Chicago Fire,14,4,2,8,17,22,-5,14
American MLS League - Eastern Conference 2014/15,New York City FC,15,3,5,7,15,19,-4,14
American MLS League - Western Conference 2014/15,Seattle Sounders FC,15,9,2,4,23,11,12,29
American MLS League - Western Conference 2014/15,Vancouver Whitecaps,16,8,2,6,18,15,3,26
American MLS League - Western Conference 2014/15,Sporting Kansas City,14,6,6,2,22,15,7,24
American MLS League - Western Conference 2014/15,Portland Timbers,15,6,4,5,15,14,1,22
American MLS League - Western Conference 2014/15,FC Dallas,15,6,4,5,18,22,-4,22
American MLS League - Western Conference 2014/15,Los Angeles Galaxy,17,5,7,5,16,19,-3,22
American MLS League - Western Conference 2014/15,Houston Dynamo,15,5,5,5,21,19,2,20
American MLS League - Western Conference 2014/15,San Jose Earthquakes,14,5,4,5,14,15,-1,19
American MLS League - Western Conference 2014/15,Real Salt Lake,15,4,6,5,13,18,-5,18
American MLS League - Western Conference 2014/15,Colorado Rapids,14,2,8,4,11,12,-1,14
American MLS League - Eastern Conference 2015/16,New York Red Bulls,34,18,6,10,62,43,19,60
American MLS League - Eastern Conference 2015/16,Columbus Crew,34,15,8,11,58,53,5,53
American MLS League - Eastern Conference 2015/16,Montreal Impact,34,15,6,13,48,44,4,51
American MLS League - Eastern Conference 2015/16,D.C. United,34,15,6,13,43,45,-2,51
American MLS League - Eastern Conference 2015/16,New England Revolution,34,14,8,12,48,47,1,50
American MLS League - Eastern Conference 2015/16,Toronto FC,34,15,4,15,58,58,0,49
American MLS League - Eastern Conference 2015/16,Orlando City SC,34,12,8,14,46,56,-10,44
American MLS League - Eastern Conference 2015/16,New York City FC,34,10,7,17,49,58,-9,37
American MLS League - Eastern Conference 2015/16,Philadelphia Union,34,10,7,17,42,55,-13,37
American MLS League - Eastern Conference 2015/16,Chicago Fire,34,8,6,20,43,58,-15,30
American MLS League - Western Conference 2015/16,FC Dallas,34,18,6,10,52,39,13,60
American MLS League - Western Conference 2015/16,Vancouver Whitecaps,34,16,5,13,45,36,9,53
American MLS League - Western Conference 2015/16,Portland Timbers,34,15,8,11,41,39,2,53
American MLS League - Western Conference 2015/16,Seattle Sounders FC,34,15,6,13,44,36,8,51
American MLS League - Western Conference 2015/16,Los Angeles Galaxy,34,14,9,11,56,46,10,51
American MLS League - Western Conference 2015/16,Sporting Kansas City,34,14,9,11,48,45,3,51
American MLS League - Western Conference 2015/16,San Jose Earthquakes,34,13,8,13,41,39,2,47
American MLS League - Western Conference 2015/16,Houston Dynamo,34,11,9,14,42,49,-7,42
American MLS League - Western Conference 2015/16,Real Salt Lake,34,11,8,15,38,48,-10,41
American MLS League - Western Conference 2015/16,Colorado Rapids,34,9,10,15,33,43,-10,37
American MLS League - Eastern Conference 2016/17,New York Red Bulls,34,16,9,9,61,44,17,57
American MLS League - Eastern Conference 2016/17,New York City FC,34,15,9,10,62,57,5,54
American MLS League - Eastern Conference 2016/17,Toronto FC,34,14,11,9,51,39,12,53
American MLS League - Eastern Conference 2016/17,D.C. United,34,11,13,10,53,47,6,46
American MLS League - Eastern Conference 2016/17,Montreal Impact,34,11,12,11,49,53,-4,45
American MLS League - Eastern Conference 2016/17,Philadelphia Union,34,11,9,14,52,55,-3,42
American MLS League - Eastern Conference 2016/17,New England Revolution,34,11,9,14,44,54,-10,42
American MLS League - Eastern Conference 2016/17,Orlando City SC,34,9,14,11,55,60,-5,41
American MLS League - Eastern Conference 2016/17,Columbus Crew,34,8,12,14,50,58,-8,36
American MLS League - Eastern Conference 2016/17,Chicago Fire,34,7,10,17,42,58,-16,31
American MLS League - Western Conference 2016/17,FC Dallas,34,17,9,8,50,40,10,60
American MLS League - Western Conference 2016/17,Colorado Rapids,34,15,13,6,39,32,7,58
American MLS League - Western Conference 2016/17,Los Angeles Galaxy,34,12,16,6,54,39,15,52
American MLS League - Western Conference 2016/17,Seattle Sounders FC,34,14,6,14,44,43,1,48
American MLS League - Western Conference 2016/17,Sporting Kansas City,34,13,8,13,42,41,1,47
American MLS League - Western Conference 2016/17,Real Salt Lake,34,12,10,12,44,46,-2,46
American MLS League - Western Conference 2016/17,Portland Timbers,34,12,8,14,48,53,-5,44
American MLS League - Western Conference 2016/17,Vancouver Whitecaps,34,10,9,15,45,52,-7,39
American MLS League - Western Conference 2016/17,San Jose Earthquakes,34,8,14,12,32,40,-8,38
American MLS League - Western Conference 2016/17,Houston Dynamo,34,7,13,14,39,45,-6,34
American MLS League - Eastern Conference 2017/18,Toronto FC,34,20,9,5,74,37,37,69
American MLS League - Eastern Conference 2017/18,New York City FC,34,16,9,9,56,43,13,57
American MLS League - Eastern Conference 2017/18,Chicago Fire,34,16,7,11,61,47,14,55
American MLS League - Eastern Conference 2017/18,Atlanta United FC,34,15,10,9,70,40,30,55
American MLS League - Eastern Conference 2017/18,Columbus Crew,34,16,6,12,53,49,4,54
American MLS League - Eastern Conference 2017/18,New York Red Bulls,34,14,8,12,53,47,6,50
American MLS League - Eastern Conference 2017/18,New England Revolution,34,13,6,15,53,61,-8,45
American MLS League - Eastern Conference 2017/18,Philadelphia Union,34,11,9,14,50,47,3,42
American MLS League - Eastern Conference 2017/18,Montreal Impact,34,11,6,17,52,58,-6,39
American MLS League - Eastern Conference 2017/18,Orlando City SC,34,10,9,15,39,58,-19,39
American MLS League - Eastern Conference 2017/18,D.C. United,34,9,5,20,31,60,-29,32
American MLS League - Western Conference 2017/18,Portland Timbers,34,15,8,11,60,50,10,53
American MLS League - Western Conference 2017/18,Seattle Sounders FC,34,14,11,9,52,39,13,53
American MLS League - Western Conference 2017/18,Vancouver Whitecaps,34,15,7,12,50,49,1,52
American MLS League - Western Conference 2017/18,Houston Dynamo,34,13,11,10,57,45,12,50
American MLS League - Western Conference 2017/18,Sporting Kansas City,34,12,13,9,40,29,11,49
American MLS League - Western Conference 2017/18,San Jose Earthquakes,34,13,7,14,39,60,-21,46
American MLS League - Western Conference 2017/18,FC Dallas,34,11,13,10,48,48,0,46
American MLS League - Western Conference 2017/18,Real Salt Lake,34,13,6,15,49,55,-6,45
American MLS League - Western Conference 2017/18,Minnesota United FC,34,10,6,18,47,70,-23,36
American MLS League - Western Conference 2017/18,Colorado Rapids,34,9,6,19,31,51,-20,33
American MLS League - Western Conference 2017/18,Los Angeles Galaxy,34,8,8,18,45,67,-22,32
American MLS League - Eastern Conference 2018/19,New York Red Bulls,34,22,5,7,62,33,29,71
American MLS League - Eastern Conference 2018/19,Atlanta United FC,34,21,6,7,70,44,26,69
American MLS League - Eastern Conference 2018/19,New York City FC,34,16,8,10,59,45,14,56
American MLS League - Eastern Conference 2018/19,D.C. United,34,14,9,11,60,50,10,51
American MLS League - Eastern Conference 2018/19,Columbus Crew,34,14,9,11,43,45,-2,51
American MLS League - Eastern Conference 2018/19,Philadelphia Union,34,15,5,14,49,50,-1,50
American MLS League - Eastern Conference 2018/19,Montreal Impact,34,14,4,16,47,53,-6,46
American MLS League - Eastern Conference 2018/19,New England Revolution,34,10,11,13,49,55,-6,41
American MLS League - Eastern Conference 2018/19,Toronto FC,34,10,6,18,59,64,-5,36
American MLS League - Eastern Conference 2018/19,Chicago Fire,34,8,8,18,48,61,-13,32
American MLS League - Eastern Conference 2018/19,Orlando City SC,34,8,4,22,43,74,-31,28
American MLS League - Western Conference 2018/19,Sporting Kansas City,34,18,8,8,65,40,25,62
American MLS League - Western Conference 2018/19,Seattle Sounders FC,34,18,5,11,52,37,15,59
American MLS League - Western Conference 2018/19,Los Angeles Football Club,34,16,9,9,68,52,16,57
American MLS League - Western Conference 2018/19,FC Dallas,34,16,9,9,52,44,8,57
American MLS League - Western Conference 2018/19,Portland Timbers,34,15,9,10,54,48,6,54
American MLS League - Western Conference 2018/19,Real Salt Lake,34,14,7,13,55,58,-3,49
American MLS League - Western Conference 2018/19,Los Angeles Galaxy,34,13,9,12,66,64,2,48
American MLS League - Western Conference 2018/19,Vancouver Whitecaps,34,13,8,13,54,67,-13,47
American MLS League - Western Conference 2018/19,Houston Dynamo,34,10,8,16,58,58,0,38
American MLS League - Western Conference 2018/19,Minnesota United FC,34,11,3,20,49,71,-22,36
American MLS League - Western Conference 2018/19,Colorado Rapids,34,8,7,19,36,63,-27,31
American MLS League - Western Conference 2018/19,San Jose Earthquakes,34,4,9,21,49,71,-22,21
American MLS League - Eastern Conference 2019/20,New York City FC,34,18,10,6,63,42,21,64
American MLS League - Eastern Conference 2019/20,Atlanta United FC,34,18,4,12,58,43,15,58
American MLS League - Eastern Conference 2019/20,Philadelphia Union,34,16,7,11,58,50,8,55
American MLS League - Eastern Conference 2019/20,Toronto FC,34,13,11,10,57,52,5,50
American MLS League - Eastern Conference 2019/20,D.C. United,34,13,11,10,42,38,4,50
American MLS League - Eastern Conference 2019/20,New York Red Bulls,34,14,6,14,53,51,2,48
American MLS League - Eastern Conference 2019/20,New England Revolution,34,11,12,11,50,57,-7,45
American MLS League - Eastern Conference 2019/20,Chicago Fire,34,10,12,12,55,47,8,42
American MLS League - Eastern Conference 2019/20,Montreal Impact,34,12,5,17,47,60,-13,41
American MLS League - Eastern Conference 2019/20,Columbus Crew,34,10,8,16,39,47,-8,38
American MLS League - Eastern Conference 2019/20,Orlando City SC,34,9,10,15,44,52,-8,37
American MLS League - Eastern Conference 2019/20,FC Cincinnati,34,6,6,22,31,75,-44,24
American MLS League - Western Conference 2019/20,Los Angeles Football Club,34,21,9,4,85,37,48,72
American MLS League - Western Conference 2019/20,Seattle Sounders FC,34,16,8,10,52,49,3,56
American MLS League - Western Conference 2019/20,Real Salt Lake,34,16,5,13,46,41,5,53
American MLS League - Western Conference 2019/20,Minnesota United FC,34,15,8,11,52,43,9,53
American MLS League - Western Conference 2019/20,Los Angeles Galaxy,34,16,3,15,58,59,-1,51
American MLS League - Western Conference 2019/20,Portland Timbers,34,14,7,13,52,49,3,49
American MLS League - Western Conference 2019/20,FC Dallas,34,13,9,12,54,46,8,48
American MLS League - Western Conference 2019/20,San Jose Earthquakes,34,13,5,16,52,55,-3,44
American MLS League - Western Conference 2019/20,Colorado Rapids,34,12,6,16,58,63,-5,42
American MLS League - Western Conference 2019/20,Houston Dynamo,34,12,4,18,49,59,-10,40
American MLS League - Western Conference 2019/20,Sporting Kansas City,34,10,8,16,49,67,-18,38
American MLS League - Western Conference 2019/20,Vancouver Whitecaps,34,8,10,16,37,59,-22,34
American MLS League - Eastern Conference 2020/21,Philadelphia Union,22,13,5,4,42,20,22,44
American MLS League - Eastern Conference 2020/21,Toronto FC,22,13,5,4,32,24,8,44
American MLS League - Eastern Conference 2020/21,Columbus Crew,21,11,5,5,33,18,15,38
American MLS League - Eastern Conference 2020/21,Orlando City SC,21,10,8,3,36,21,15,38
American MLS League - Eastern Conference 2020/21,New York City FC,22,11,3,8,33,22,11,36
American MLS League - Eastern Conference 2020/21,New England Revolution,22,8,8,6,26,23,3,32
American MLS League - Eastern Conference 2020/21,Nashville SC,21,7,8,6,21,19,2,29
American MLS League - Eastern Conference 2020/21,New York Red Bulls,22,8,5,9,27,30,-3,29
American MLS League - Eastern Conference 2020/21,Montreal Impact,22,7,2,13,30,41,-11,23
American MLS League - Eastern Conference 2020/21,Chicago Fire,21,5,7,9,28,33,-5,22
American MLS League - Eastern Conference 2020/21,Atlanta United FC,22,6,4,12,22,28,-6,22
American MLS League - Eastern Conference 2020/21,Inter Miami CF,22,6,3,13,23,34,-11,21
American MLS League - Eastern Conference 2020/21,D.C. United,22,5,6,11,23,38,-15,21
American MLS League - Eastern Conference 2020/21,FC Cincinnati,22,4,4,14,11,34,-23,16
American MLS League - Western Conference 2020/21,Portland Timbers,21,11,5,5,45,33,12,38
American MLS League - Western Conference 2020/21,Sporting Kansas City,20,11,3,6,36,25,11,36
American MLS League - Western Conference 2020/21,Seattle Sounders FC,20,10,5,5,39,21,18,35
American MLS League - Western Conference 2020/21,Minnesota United FC,19,8,6,5,31,24,7,30
American MLS League - Western Conference 2020/21,Los Angeles Football Club,20,9,4,7,44,35,9,31
American MLS League - Western Conference 2020/21,FC Dallas,20,8,7,5,27,21,6,31
American MLS League - Western Conference 2020/21,Colorado Rapids,16,6,4,6,29,27,2,22
American MLS League - Western Conference 2020/21,San Jose Earthquakes,21,7,6,8,31,45,-14,27
American MLS League - Western Conference 2020/21,Vancouver Whitecaps,22,8,0,14,24,44,-20,24
American MLS League - Western Conference 2020/21,Los Angeles Galaxy,20,6,3,11,26,42,-16,21
American MLS League - Western Conference 2020/21,Real Salt Lake,21,5,7,9,25,33,-8,22
American MLS League - Western Conference 2020/21,Houston Dynamo,22,4,9,9,29,38,-9,21
Barclays Premier League - Premier League 2009/10,Chelsea,38,27,5,6,103,32,71,86
Barclays Premier League - Premier League 2009/10,Manchester United,38,27,4,7,86,28,58,85
Barclays Premier League - Premier League 2009/10,Arsenal,38,23,6,9,83,41,42,75
Barclays Premier League - Premier League 2009/10,Tottenham Hotspur,38,21,7,10,67,41,26,70
Barclays Premier League - Premier League 2009/10,Manchester City,38,18,13,7,73,45,28,67
Barclays Premier League - Premier League 2009/10,Aston Villa,38,17,13,8,52,39,13,64
Barclays Premier League - Premier League 2009/10,Liverpool,38,18,9,11,61,35,26,63
Barclays Premier League - Premier League 2009/10,Everton,38,16,13,9,60,49,11,61
Barclays Premier League - Premier League 2009/10,Birmingham City,38,13,11,14,38,47,-9,50
Barclays Premier League - Premier League 2009/10,Blackburn Rovers,38,13,11,14,41,55,-14,50
Barclays Premier League - Premier League 2009/10,Stoke City,38,11,14,13,34,48,-14,47
Barclays Premier League - Premier League 2009/10,Fulham,38,12,10,16,39,46,-7,46
Barclays Premier League - Premier League 2009/10,Sunderland,38,11,11,16,48,56,-8,44
Barclays Premier League - Premier League 2009/10,Bolton Wanderers,38,10,9,19,42,67,-25,39
Barclays Premier League - Premier League 2009/10,Wolverhampton Wanderers,38,9,11,18,32,56,-24,38
Barclays Premier League - Premier League 2009/10,Wigan Athletic,38,9,9,20,37,79,-42,36
Barclays Premier League - Premier League 2009/10,West Ham United,38,8,11,19,47,66,-19,35
Barclays Premier League - Premier League 2009/10,Burnley,38,8,6,24,42,82,-40,30
Barclays Premier League - Premier League 2009/10,Hull City,38,6,12,20,34,75,-41,30
Barclays Premier League - Premier League 2009/10,Portsmouth *,38,7,7,24,34,66,-32,19
Barclays Premier League 2010/11,Manchester United,38,23,11,4,78,37,41,80
Barclays Premier League 2010/11,Chelsea,38,21,8,9,69,33,36,71
Barclays Premier League 2010/11,Manchester City,38,21,8,9,60,33,27,71
Barclays Premier League 2010/11,Arsenal,38,19,11,8,72,43,29,68
Barclays Premier League 2010/11,Tottenham Hotspur,38,16,14,8,55,46,9,62
Barclays Premier League 2010/11,Liverpool,38,17,7,14,59,44,15,58
Barclays Premier League 2010/11,Everton,38,13,15,10,51,45,6,54
Barclays Premier League 2010/11,Fulham,38,11,16,11,49,43,6,49
Barclays Premier League 2010/11,Aston Villa,38,12,12,14,48,59,-11,48
Barclays Premier League 2010/11,Sunderland,38,12,11,15,45,56,-11,47
Barclays Premier League 2010/11,West Bromwich Albion,38,12,11,15,56,71,-15,47
Barclays Premier League 2010/11,Newcastle United,38,11,13,14,56,57,-1,46
Barclays Premier League 2010/11,Stoke City,38,13,7,18,46,48,-2,46
Barclays Premier League 2010/11,Bolton Wanderers,38,12,10,16,52,56,-4,46
Barclays Premier League 2010/11,Blackburn Rovers,38,11,10,17,46,59,-13,43
Barclays Premier League 2010/11,Wigan Athletic,38,9,15,14,40,61,-21,42
Barclays Premier League 2010/11,Wolverhampton Wanderers,38,11,7,20,46,66,-20,40
Barclays Premier League 2010/11,Birmingham City,38,8,15,15,37,58,-21,39
Barclays Premier League 2010/11,Blackpool,38,10,9,19,55,78,-23,39
Barclays Premier League 2010/11,West Ham United,38,7,12,19,43,70,-27,33
Barclays Premier League 2011/12,Manchester City,38,28,5,5,93,29,64,89
Barclays Premier League 2011/12,Manchester United,38,28,5,5,89,33,56,89
Barclays Premier League 2011/12,Arsenal,38,21,7,10,74,49,25,70
Barclays Premier League 2011/12,Tottenham Hotspur,38,20,9,9,66,41,25,69
Barclays Premier League 2011/12,Newcastle United,38,19,8,11,56,51,5,65
Barclays Premier League 2011/12,Chelsea,38,18,10,10,65,46,19,64
Barclays Premier League 2011/12,Everton,38,15,11,12,50,40,10,56
Barclays Premier League 2011/12,Liverpool,38,14,10,14,47,40,7,52
Barclays Premier League 2011/12,Fulham,38,14,10,14,48,51,-3,52
Barclays Premier League 2011/12,West Bromwich Albion,38,13,8,17,45,52,-7,47
Barclays Premier League 2011/12,Swansea City,38,12,11,15,44,51,-7,47
Barclays Premier League 2011/12,Norwich City,38,12,11,15,52,66,-14,47
Barclays Premier League 2011/12,Sunderland,38,11,12,15,45,46,-1,45
Barclays Premier League 2011/12,Stoke City,38,11,12,15,36,53,-17,45
Barclays Premier League 2011/12,Wigan Athletic,38,11,10,17,42,62,-20,43
Barclays Premier League 2011/12,Aston Villa,38,7,17,14,37,53,-16,38
Barclays Premier League 2011/12,Queens Park Rangers,38,10,7,21,43,66,-23,37
Barclays Premier League 2011/12,Bolton Wanderers,38,10,6,22,46,77,-31,36
Barclays Premier League 2011/12,Blackburn Rovers,38,8,7,23,48,78,-30,31
Barclays Premier League 2011/12,Wolverhampton Wanderers,38,5,10,23,40,82,-42,25
Barclays Premier League 2012/13,Manchester United,38,28,5,5,86,43,43,89
Barclays Premier League 2012/13,Manchester City,38,23,9,6,66,34,32,78
Barclays Premier League 2012/13,Chelsea,38,22,9,7,75,39,36,75
Barclays Premier League 2012/13,Arsenal,38,21,10,7,72,37,35,73
Barclays Premier League 2012/13,Tottenham Hotspur,38,21,9,8,66,46,20,72
Barclays Premier League 2012/13,Everton,38,16,15,7,55,40,15,63
Barclays Premier League 2012/13,Liverpool,38,16,13,9,71,43,28,61
Barclays Premier League 2012/13,West Bromwich Albion,38,14,7,17,53,57,-4,49
Barclays Premier League 2012/13,Swansea City,38,11,13,14,47,51,-4,46
Barclays Premier League 2012/13,West Ham United,38,12,10,16,45,53,-8,46
Barclays Premier League 2012/13,Norwich City,38,10,14,14,41,58,-17,44
Barclays Premier League 2012/13,Fulham,38,11,10,17,50,60,-10,43
Barclays Premier League 2012/13,Stoke City,38,9,15,14,34,45,-11,42
Barclays Premier League 2012/13,Southampton,38,9,14,15,49,60,-11,41
Barclays Premier League 2012/13,Aston Villa,38,10,11,17,47,69,-22,41
Barclays Premier League 2012/13,Newcastle United,38,11,8,19,45,68,-23,41
Barclays Premier League 2012/13,Sunderland,38,9,12,17,41,54,-13,39
Barclays Premier League 2012/13,Wigan Athletic,38,9,9,20,47,73,-26,36
Barclays Premier League 2012/13,Reading,38,6,10,22,43,73,-30,28
Barclays Premier League 2012/13,Queens Park Rangers,38,4,13,21,30,60,-30,25
Barclays Premier League 2013/14,Manchester City,38,27,5,6,102,37,65,86
Barclays Premier League 2013/14,Liverpool,38,26,6,6,101,50,51,84
Barclays Premier League 2013/14,Chelsea,38,25,7,6,71,27,44,82
Barclays Premier League 2013/14,Arsenal,38,24,7,7,68,41,27,79
Barclays Premier League 2013/14,Everton,38,21,9,8,61,39,22,72
Barclays Premier League 2013/14,Tottenham Hotspur,38,21,6,11,55,51,4,69
Barclays Premier League 2013/14,Manchester United,38,19,7,12,64,43,21,64
Barclays Premier League 2013/14,Southampton,38,15,11,12,54,46,8,56
Barclays Premier League 2013/14,Stoke City,38,13,11,14,45,52,-7,50
Barclays Premier League 2013/14,Newcastle United,38,15,4,19,43,59,-16,49
Barclays Premier League 2013/14,Crystal Palace,38,13,6,19,33,48,-15,45
Barclays Premier League 2013/14,Swansea City,38,11,9,18,54,54,0,42
Barclays Premier League 2013/14,West Ham United,38,11,7,20,40,51,-11,40
Barclays Premier League 2013/14,Sunderland,38,10,8,20,41,60,-19,38
Barclays Premier League 2013/14,Aston Villa,38,10,8,20,39,61,-22,38
Barclays Premier League 2013/14,Hull City,38,10,7,21,38,53,-15,37
Barclays Premier League 2013/14,West Bromwich Albion,38,7,15,16,43,59,-16,36
Barclays Premier League 2013/14,Norwich City,38,8,9,21,28,62,-34,33
Barclays Premier League 2013/14,Fulham,38,9,5,24,40,85,-45,32
Barclays Premier League 2013/14,Cardiff City,38,7,9,22,32,74,-42,30
Barclays Premier League 2014/15,Chelsea,38,26,9,3,73,32,41,87
Barclays Premier League 2014/15,Manchester City,38,24,7,7,83,38,45,79
Barclays Premier League 2014/15,Arsenal,38,22,9,7,71,36,35,75
Barclays Premier League 2014/15,Manchester United,38,20,10,8,62,37,25,70
Barclays Premier League 2014/15,Tottenham Hotspur,38,19,7,12,58,53,5,64
Barclays Premier League 2014/15,Liverpool,38,18,8,12,52,48,4,62
Barclays Premier League 2014/15,Southampton,38,18,6,14,54,33,21,60
Barclays Premier League 2014/15,Swansea City,38,16,8,14,46,49,-3,56
Barclays Premier League 2014/15,Stoke City,38,15,9,14,48,45,3,54
Barclays Premier League 2014/15,Crystal Palace,38,13,9,16,47,51,-4,48
Barclays Premier League 2014/15,Everton,38,12,11,15,48,50,-2,47
Barclays Premier League 2014/15,West Ham United,38,12,11,15,44,47,-3,47
Barclays Premier League 2014/15,West Bromwich Albion,38,11,11,16,38,51,-13,44
Barclays Premier League 2014/15,Leicester City,38,11,8,19,46,55,-9,41
Barclays Premier League 2014/15,Newcastle United,38,10,9,19,40,63,-23,39
Barclays Premier League 2014/15,Sunderland,38,7,17,14,31,53,-22,38
Barclays Premier League 2014/15,Aston Villa,38,10,8,20,31,57,-26,38
Barclays Premier League 2014/15,Hull City,38,8,11,19,33,51,-18,35
Barclays Premier League 2014/15,Burnley,38,7,12,19,28,53,-25,33
Barclays Premier League 2014/15,Queens Park Rangers,38,8,6,24,42,73,-31,30
Barclays Premier League 2015/16,Leicester City,38,23,12,3,68,36,32,81
Barclays Premier League 2015/16,Arsenal,38,20,11,7,65,36,29,71
Barclays Premier League 2015/16,Tottenham Hotspur,38,19,13,6,69,35,34,70
Barclays Premier League 2015/16,Manchester City,38,19,9,10,71,41,30,66
Barclays Premier League 2015/16,Manchester United,38,19,9,10,49,35,14,66
Barclays Premier League 2015/16,Southampton,38,18,9,11,59,41,18,63
Barclays Premier League 2015/16,West Ham United,38,16,14,8,65,51,14,62
Barclays Premier League 2015/16,Liverpool,38,16,12,10,63,50,13,60
Barclays Premier League 2015/16,Stoke City,38,14,9,15,41,55,-14,51
Barclays Premier League 2015/16,Chelsea,38,12,14,12,59,53,6,50
Barclays Premier League 2015/16,Everton,38,11,14,13,59,55,4,47
Barclays Premier League 2015/16,Swansea City,38,12,11,15,42,52,-10,47
Barclays Premier League 2015/16,Watford,38,12,9,17,40,50,-10,45
Barclays Premier League 2015/16,West Bromwich Albion,38,10,13,15,34,48,-14,43
Barclays Premier League 2015/16,Crystal Palace,38,11,9,18,39,51,-12,42
Barclays Premier League 2015/16,Bournemouth,38,11,9,18,45,67,-22,42
Barclays Premier League 2015/16,Sunderland,38,9,12,17,48,62,-14,39
Barclays Premier League 2015/16,Newcastle United,38,9,10,19,44,65,-21,37
Barclays Premier League 2015/16,Norwich City,38,9,7,22,39,67,-28,34
Barclays Premier League 2015/16,Aston Villa,38,3,8,27,27,76,-49,17
Premier League 2016/17,Chelsea,38,30,3,5,85,33,52,93
Premier League 2016/17,Tottenham Hotspur,38,26,8,4,86,26,60,86
Premier League 2016/17,Manchester City,38,23,9,6,80,39,41,78
Premier League 2016/17,Liverpool,38,22,10,6,78,42,36,76
Premier League 2016/17,Arsenal,38,23,6,9,77,44,33,75
Premier League 2016/17,Manchester United,38,18,15,5,54,29,25,69
Premier League 2016/17,Everton,38,17,10,11,62,44,18,61
Premier League 2016/17,Southampton,38,12,10,16,41,48,-7,46
Premier League 2016/17,Bournemouth,38,12,10,16,55,67,-12,46
Premier League 2016/17,West Bromwich Albion,38,12,9,17,43,51,-8,45
Premier League 2016/17,West Ham United,38,12,9,17,47,64,-17,45
Premier League 2016/17,Leicester City,38,12,8,18,48,63,-15,44
Premier League 2016/17,Stoke City,38,11,11,16,41,56,-15,44
Premier League 2016/17,Crystal Palace,38,12,5,21,50,63,-13,41
Premier League 2016/17,Swansea City,38,12,5,21,45,70,-25,41
Premier League 2016/17,Burnley,38,11,7,20,39,55,-16,40
Premier League 2016/17,Watford,38,11,7,20,40,68,-28,40
Premier League 2016/17,Hull City,38,9,7,22,37,80,-43,34
Premier League 2016/17,Middlesbrough,38,5,13,20,27,53,-26,28
Premier League 2016/17,Sunderland,38,6,6,26,29,69,-40,24
Premier League 2017/18,Manchester City,38,32,4,2,106,27,79,100
Premier League 2017/18,Manchester United,38,25,6,7,68,28,40,81
Premier League 2017/18,Tottenham Hotspur,38,23,8,7,74,36,38,77
Premier League 2017/18,Liverpool,38,21,12,5,84,38,46,75
Premier League 2017/18,Chelsea,38,21,7,10,62,38,24,70
Premier League 2017/18,Arsenal,38,19,6,13,74,51,23,63
Premier League 2017/18,Burnley,38,14,12,12,36,39,-3,54
Premier League 2017/18,Everton,38,13,10,15,44,58,-14,49
Premier League 2017/18,Leicester City,38,12,11,15,56,60,-4,47
Premier League 2017/18,Newcastle United,38,12,8,18,39,47,-8,44
Premier League 2017/18,Crystal Palace,38,11,11,16,45,55,-10,44
Premier League 2017/18,Bournemouth,38,11,11,16,45,61,-16,44
Premier League 2017/18,West Ham United,38,10,12,16,48,68,-20,42
Premier League 2017/18,Watford,38,11,8,19,44,64,-20,41
Premier League 2017/18,Brighton and Hove Albion,38,9,13,16,34,54,-20,40
Premier League 2017/18,Huddersfield Town,38,9,10,19,28,58,-30,37
Premier League 2017/18,Southampton,38,7,15,16,37,56,-19,36
Premier League 2017/18,Swansea City,38,8,9,21,28,56,-28,33
Premier League 2017/18,Stoke City,38,7,12,19,35,68,-33,33
Premier League 2017/18,West Bromwich Albion,38,6,13,19,31,56,-25,31
Premier League 2018/19,Manchester City,38,32,2,4,95,23,72,98
Premier League 2018/19,Liverpool,38,30,7,1,89,22,67,97
Premier League 2018/19,Chelsea,38,21,9,8,63,39,24,72
Premier League 2018/19,Tottenham Hotspur,38,23,2,13,67,39,28,71
Premier League 2018/19,Arsenal,38,21,7,10,73,51,22,70
Premier League 2018/19,Manchester United,38,19,9,10,65,54,11,66
Premier League 2018/19,Wolverhampton Wanderers,38,16,9,13,47,46,1,57
Premier League 2018/19,Everton,38,15,9,14,54,46,8,54
Premier League 2018/19,Leicester City,38,15,7,16,51,48,3,52
Premier League 2018/19,West Ham United,38,15,7,16,52,55,-3,52
Premier League 2018/19,Watford,38,14,8,16,52,59,-7,50
Premier League 2018/19,Crystal Palace,38,14,7,17,51,53,-2,49
Premier League 2018/19,Newcastle United,38,12,9,17,42,48,-6,45
Premier League 2018/19,Bournemouth,38,13,6,19,56,70,-14,45
Premier League 2018/19,Burnley,38,11,7,20,45,68,-23,40
Premier League 2018/19,Southampton,38,9,12,17,45,65,-20,39
Premier League 2018/19,Brighton and Hove Albion,38,9,9,20,35,60,-25,36
Premier League 2018/19,Cardiff City,38,10,4,24,34,69,-35,34
Premier League 2018/19,Fulham,38,7,5,26,34,81,-47,26
Premier League 2018/19,Huddersfield Town,38,3,7,28,22,76,-54,16
Premier League 2019/20,Liverpool,38,32,3,3,85,33,52,99
Premier League 2019/20,Manchester City,38,26,3,9,102,35,67,81
Premier League 2019/20,Manchester United,38,18,12,8,66,36,30,66
Premier League 2019/20,Chelsea,38,20,6,12,69,54,15,66
Premier League 2019/20,Leicester City,38,18,8,12,67,41,26,62
Premier League 2019/20,Tottenham Hotspur,38,16,11,11,61,47,14,59
Premier League 2019/20,Wolverhampton Wanderers,38,15,14,9,51,40,11,59
Premier League 2019/20,Arsenal,38,14,14,10,56,48,8,56
Premier League 2019/20,Sheffield United,38,14,12,12,39,39,0,54
Premier League 2019/20,Burnley,38,15,9,14,43,50,-7,54
Premier League 2019/20,Southampton,38,15,7,16,51,60,-9,52
Premier League 2019/20,Everton,38,13,10,15,44,56,-12,49
Premier League 2019/20,Newcastle United,38,11,11,16,38,58,-20,44
Premier League 2019/20,Crystal Palace,38,11,10,17,31,50,-19,43
Premier League 2019/20,Brighton and Hove Albion,38,9,14,15,39,54,-15,41
Premier League 2019/20,West Ham United,38,10,9,19,49,62,-13,39
Premier League 2019/20,Aston Villa,38,9,8,21,41,67,-26,35
Premier League 2019/20,Bournemouth,38,9,7,22,40,65,-25,34
Premier League 2019/20,Watford,38,8,10,20,36,64,-28,34
Premier League 2019/20,Norwich City,38,5,6,27,26,75,-49,21
Premier League 2020/21,Liverpool,7,5,1,1,17,15,2,16
Premier League 2020/21,Leicester City,7,5,0,2,17,9,8,15
Premier League 2020/21,Tottenham Hotspur,7,4,2,1,18,9,9,14
Premier League 2020/21,Everton,7,4,1,2,15,11,4,13
Premier League 2020/21,Southampton,7,4,1,2,14,12,2,13
Premier League 2020/21,Wolverhampton Wanderers,7,4,1,2,8,8,0,13
Premier League 2020/21,Chelsea,7,3,3,1,16,9,7,12
Premier League 2020/21,Aston Villa,6,4,0,2,15,9,6,12
Premier League 2020/21,Arsenal,7,4,0,3,9,7,2,12
Premier League 2020/21,Manchester City,6,3,2,1,9,8,1,11
Premier League 2020/21,Newcastle United,7,3,2,2,10,11,-1,11
Premier League 2020/21,Leeds United,7,3,1,3,13,13,0,10
Premier League 2020/21,Crystal Palace,7,3,1,3,8,11,-3,10
Premier League 2020/21,West Ham United,7,2,2,3,13,10,3,8
Premier League 2020/21,Manchester United,6,2,1,3,9,13,-4,7
Premier League 2020/21,Brighton and Hove Albion,7,1,2,4,11,14,-3,5
Premier League 2020/21,Fulham,7,1,1,5,7,14,-7,4
Premier League 2020/21,West Bromwich Albion,7,0,3,4,6,16,-10,3
Premier League 2020/21,Sheffield United,7,0,1,6,3,10,-7,1
Premier League 2020/21,Burnley,6,0,1,5,3,12,-9,1
The Irn-Bru Scottish Football League Championship First Division 2009/10,Inverness CT,36,21,10,5,72,32,40,73
The Irn-Bru Scottish Football League Championship First Division 2009/10,Dundee,36,16,13,7,48,34,14,61
The Irn-Bru Scottish Football League Championship First Division 2009/10,Dunfermline Athletic,36,17,7,12,54,44,10,58
The Irn-Bru Scottish Football League Championship First Division 2009/10,Queen Of The South,36,15,11,10,53,40,13,56
The Irn-Bru Scottish Football League Championship First Division 2009/10,Ross County,36,15,11,10,46,44,2,56
The Irn-Bru Scottish Football League Championship First Division 2009/10,Partick Thistle,36,14,6,16,43,40,3,48
The Irn-Bru Scottish Football League Championship First Division 2009/10,Raith Rovers,36,11,9,16,36,47,-11,42
The Irn-Bru Scottish Football League Championship First Division 2009/10,Morton,36,11,4,21,40,65,-25,37
The Irn-Bru Scottish Football League Championship First Division 2009/10,Airdrieonians,36,8,9,19,41,56,-15,33
The Irn-Bru Scottish Football League Championship First Division 2009/10,Ayr United,36,7,10,19,29,60,-31,31
The Irn-Bru Scottish Football League Championship First Division 2010/11,Dunfermline Athletic,36,20,10,6,66,31,35,70
The Irn-Bru Scottish Football League Championship First Division 2010/11,Raith Rovers,36,17,9,10,47,35,12,60
The Irn-Bru Scottish Football League Championship First Division 2010/11,Falkirk,36,17,7,12,57,41,16,58
The Irn-Bru Scottish Football League Championship First Division 2010/11,Queen Of The South,36,14,7,15,54,53,1,49
The Irn-Bru Scottish Football League Championship First Division 2010/11,Partick Thistle,36,12,11,13,44,39,5,47
The Irn-Bru Scottish Football League Championship First Division 2010/11,Dundee *,36,19,12,5,54,34,20,44
The Irn-Bru Scottish Football League Championship First Division 2010/11,Morton,36,11,10,15,39,43,-4,43
The Irn-Bru Scottish Football League Championship First Division 2010/11,Ross County,36,9,14,13,30,34,-4,41
The Irn-Bru Scottish Football League Championship First Division 2010/11,Cowdenbeath,36,9,8,19,41,72,-31,35
The Irn-Bru Scottish Football League Championship First Division 2010/11,Stirling Albion,36,4,8,24,32,82,-50,20
The Irn-Bru Scottish Football League Championship First Division 2011/12,Ross County,36,22,13,1,72,32,40,79
The Irn-Bru Scottish Football League Championship First Division 2011/12,Dundee,36,15,10,11,53,43,10,55
The Irn-Bru Scottish Football League Championship First Division 2011/12,Falkirk,36,13,13,10,53,48,5,52
The Irn-Bru Scottish Football League Championship First Division 2011/12,Hamilton Academical,36,14,7,15,55,56,-1,49
The Irn-Bru Scottish Football League Championship First Division 2011/12,Livingston,36,13,9,14,56,54,2,48
The Irn-Bru Scottish Football League Championship First Division 2011/12,Partick Thistle,36,12,11,13,50,39,11,47
The Irn-Bru Scottish Football League Championship First Division 2011/12,Raith Rovers,36,11,11,14,46,49,-3,44
The Irn-Bru Scottish Football League Championship First Division 2011/12,Morton,36,10,12,14,40,55,-15,42
The Irn-Bru Scottish Football League Championship First Division 2011/12,Ayr United,36,9,11,16,44,67,-23,38
The Irn-Bru Scottish Football League Championship First Division 2011/12,Queen Of The South,36,7,11,18,38,64,-26,32
The Irn-Bru Scottish First Division 2012/13,Partick Thistle,36,23,9,4,76,28,48,78
The Irn-Bru Scottish First Division 2012/13,Morton,36,20,7,9,73,47,26,67
The Irn-Bru Scottish First Division 2012/13,Falkirk,36,15,8,13,52,48,4,53
The Irn-Bru Scottish First Division 2012/13,Livingston,36,14,10,12,58,56,2,52
The Irn-Bru Scottish First Division 2012/13,Hamilton Academical,36,14,9,13,52,45,7,51
The Irn-Bru Scottish First Division 2012/13,Raith Rovers,36,11,13,12,45,48,-3,46
The Irn-Bru Scottish First Division 2012/13,Dumbarton,36,13,4,19,58,83,-25,43
The Irn-Bru Scottish First Division 2012/13,Cowdenbeath,36,8,12,16,51,65,-14,36
The Irn-Bru Scottish First Division 2012/13,Dunfermline Athletic *,36,14,7,15,62,59,3,34
The Irn-Bru Scottish First Division 2012/13,Airdrieonians,36,5,7,24,41,89,-48,22
Scottish Championship 2013/14,Dundee,36,21,6,9,54,26,28,69
Scottish Championship 2013/14,Hamilton Academical,36,19,10,7,68,41,27,67
Scottish Championship 2013/14,Falkirk,36,19,9,8,59,33,26,66
Scottish Championship 2013/14,Queen Of The South,36,16,7,13,53,39,14,55
Scottish Championship 2013/14,Dumbarton,36,15,6,15,65,64,1,51
Scottish Championship 2013/14,Livingston,36,13,7,16,51,56,-5,46
Scottish Championship 2013/14,Raith Rovers,36,11,9,16,48,61,-13,42
Scottish Championship 2013/14,Alloa Athletic,36,11,7,18,34,51,-17,40
Scottish Championship 2013/14,Cowdenbeath,36,11,7,18,50,72,-22,40
Scottish Championship 2013/14,Morton,36,6,8,22,32,71,-39,26
Scottish Championship 2014/15,Hearts,36,29,4,3,96,26,70,91
Scottish Championship 2014/15,Hibernian,36,21,7,8,70,32,38,70
Scottish Championship 2014/15,Rangers,36,19,10,7,69,39,30,67
Scottish Championship 2014/15,Queen Of The South,36,17,9,10,58,41,17,60
Scottish Championship 2014/15,Falkirk,36,14,11,11,48,48,0,53
Scottish Championship 2014/15,Raith Rovers,36,12,7,17,42,65,-23,43
Scottish Championship 2014/15,Dumbarton,36,9,7,20,36,79,-43,34
Scottish Championship 2014/15,Livingston *,36,8,8,20,41,53,-12,27
Scottish Championship 2014/15,Alloa Athletic,36,6,9,21,34,56,-22,27
Scottish Championship 2014/15,Cowdenbeath,36,7,4,25,31,86,-55,25
Scottish Championship 2015/16,Rangers,36,25,6,5,88,34,54,81
Scottish Championship 2015/16,Falkirk,36,19,13,4,61,34,27,70
Scottish Championship 2015/16,Hibernian,36,21,7,8,59,34,25,70
Scottish Championship 2015/16,Raith Rovers,36,18,8,10,52,46,6,62
Scottish Championship 2015/16,Morton,36,11,10,15,39,42,-3,43
Scottish Championship 2015/16,St Mirren,36,11,9,16,44,53,-9,42
Scottish Championship 2015/16,Queen Of The South,36,12,6,18,46,56,-10,42
Scottish Championship 2015/16,Dumbarton,36,10,7,19,35,66,-31,37
Scottish Championship 2015/16,Livingston,36,8,7,21,37,51,-14,31
Scottish Championship 2015/16,Alloa Athletic,36,4,9,23,22,67,-45,21
Scottish Championship 2016/17,Hibernian,36,19,14,3,59,25,34,71
Scottish Championship 2016/17,Falkirk,36,16,12,8,58,40,18,60
Scottish Championship 2016/17,Dundee United,36,15,12,9,50,42,8,57
Scottish Championship 2016/17,Morton,36,13,13,10,44,41,3,52
Scottish Championship 2016/17,Dunfermline Athletic,36,12,12,12,46,43,3,48
Scottish Championship 2016/17,Queen Of The South,36,11,10,15,46,52,-6,43
Scottish Championship 2016/17,St Mirren,36,9,12,15,52,56,-4,39
Scottish Championship 2016/17,Dumbarton,36,9,12,15,46,56,-10,39
Scottish Championship 2016/17,Raith Rovers,36,10,9,17,35,52,-17,39
Scottish Championship 2016/17,Ayr United,36,7,12,17,33,62,-29,33
Scottish Championship 2017/18,St Mirren,36,23,5,8,63,36,27,74
Scottish Championship 2017/18,Livingston,36,17,11,8,56,37,19,62
Scottish Championship 2017/18,Dundee United,36,18,7,11,52,42,10,61
Scottish Championship 2017/18,Dunfermline Athletic,36,16,11,9,60,35,25,59
Scottish Championship 2017/18,Inverness CT,36,16,9,11,53,37,16,57
Scottish Championship 2017/18,Queen Of The South,36,14,10,12,59,53,6,52
Scottish Championship 2017/18,Morton,36,13,11,12,47,40,7,50
Scottish Championship 2017/18,Falkirk,36,12,11,13,45,49,-4,47
Scottish Championship 2017/18,Dumbarton,36,7,9,20,27,63,-36,30
Scottish Championship 2017/18,Brechin City,36,0,4,32,20,90,-70,4
Scottish Championship 2018/19,Ross County,36,21,8,7,63,34,29,71
Scottish Championship 2018/19,Dundee United,36,19,8,9,49,40,9,65
Scottish Championship 2018/19,Inverness CT,36,14,14,8,48,40,8,56
Scottish Championship 2018/19,Ayr United,36,15,9,12,50,38,12,54
Scottish Championship 2018/19,Morton,36,11,13,12,36,45,-9,46
Scottish Championship 2018/19,Partick Thistle,36,12,7,17,43,52,-9,43
Scottish Championship 2018/19,Dunfermline Athletic,36,11,8,17,33,40,-7,41
Scottish Championship 2018/19,Alloa Athletic,36,10,9,17,39,53,-14,39
Scottish Championship 2018/19,Queen Of The South,36,9,11,16,41,48,-7,38
Scottish Championship 2018/19,Falkirk,36,9,11,16,37,49,-12,38
Scottish Championship 2019/20,Dundee United,28,18,5,5,52,22,30,59
Scottish Championship 2019/20,Inverness CT,27,14,3,10,39,32,7,45
Scottish Championship 2019/20,Dundee,27,11,8,8,32,31,1,41
Scottish Championship 2019/20,Ayr United,27,12,4,11,38,35,3,40
Scottish Championship 2019/20,Arbroath,26,10,6,10,24,26,-2,36
Scottish Championship 2019/20,Dunfermline Athletic,28,10,7,11,41,36,5,37
Scottish Championship 2019/20,Morton,28,10,6,12,45,52,-7,36
Scottish Championship 2019/20,Alloa Athletic,28,7,10,11,33,43,-10,31
Scottish Championship 2019/20,Queen Of The South,28,7,7,14,28,40,-12,28
Scottish Championship 2019/20,Partick Thistle,27,6,8,13,32,47,-15,26
Scottish Championship 2020/21,Dunfermline Athletic,3,3,0,0,10,4,6,9
Scottish Championship 2020/21,Raith Rovers,3,2,1,0,9,3,6,7
Scottish Championship 2020/21,Hearts,2,2,0,0,7,2,5,6
Scottish Championship 2020/21,Morton,3,2,0,1,4,3,1,6
Scottish Championship 2020/21,Ayr United,3,1,1,1,5,5,0,4
Scottish Championship 2020/21,Inverness CT,3,1,1,1,5,5,0,4
Scottish Championship 2020/21,Dundee,3,1,1,1,4,7,-3,4
Scottish Championship 2020/21,Alloa Athletic,2,0,0,2,1,5,-4,0
Scottish Championship 2020/21,Queen Of The South,3,0,0,3,5,10,-5,0
Scottish Championship 2020/21,Arbroath,3,0,0,3,1,7,-6,0
Scottish League Cup - Group A 2016/17,Peterhead,4,2,1,1,8,6,2,8
Scottish League Cup - Group A 2016/17,East Fife,4,2,1,1,5,4,1,8
Scottish League Cup - Group A 2016/17,Dundee,4,2,1,1,15,5,10,7
Scottish League Cup - Group A 2016/17,Forfar Athletic,4,1,1,2,4,11,-7,5
Scottish League Cup - Group A 2016/17,Dumbarton,4,0,2,2,7,13,-6,2
Scottish League Cup - Group B 2016/17,St. Johnstone,4,3,1,0,11,2,9,10
Scottish League Cup - Group B 2016/17,Falkirk,4,2,0,2,5,4,1,6
Scottish League Cup - Group B 2016/17,Stirling Albion,4,2,0,2,6,7,-1,6
Scottish League Cup - Group B 2016/17,Brechin City,4,1,1,2,5,8,-3,5
Scottish League Cup - Group B 2016/17,Elgin City,4,1,0,3,6,12,-6,3
Scottish League Cup - Group C 2016/17,Inverness CT,4,3,1,0,15,3,12,10
Scottish League Cup - Group C 2016/17,Dundee United,4,2,2,0,10,3,7,10
Scottish League Cup - Group C 2016/17,Dunfermline Athletic,4,2,0,2,7,7,0,6
Scottish League Cup - Group C 2016/17,Cowdenbeath,4,1,0,3,4,11,-7,3
Scottish League Cup - Group C 2016/17,Arbroath,4,0,1,3,1,13,-12,1
Scottish League Cup - Group D 2016/17,Alloa Athletic,4,4,0,0,10,2,8,12
Scottish League Cup - Group D 2016/17,Raith Rovers,4,2,1,1,5,4,1,8
Scottish League Cup - Group D 2016/17,Ross County,4,2,1,1,11,4,7,7
Scottish League Cup - Group D 2016/17,Cove Rangers,4,1,0,3,4,13,-9,3
Scottish League Cup - Group D 2016/17,Montrose,4,0,0,4,1,8,-7,0
Scottish League Cup - Group E 2016/17,Partick Thistle,4,4,0,0,9,2,7,12
Scottish League Cup - Group E 2016/17,Queen Of The South,4,3,0,1,6,2,4,9
Scottish League Cup - Group E 2016/17,Airdrieonians,4,1,1,2,5,7,-2,5
Scottish League Cup - Group E 2016/17,Queen's Park,4,1,1,2,5,7,-2,4
Scottish League Cup - Group E 2016/17,Stenhousemuir,4,0,0,4,2,9,-7,0
Scottish League Cup - Group F 2016/17,Rangers,4,4,0,0,10,0,10,12
Scottish League Cup - Group F 2016/17,Motherwell,4,3,0,1,9,3,6,9
Scottish League Cup - Group F 2016/17,Stranraer,4,2,0,2,5,8,-3,6
Scottish League Cup - Group F 2016/17,Annan Athletic,4,1,0,3,4,7,-3,3
Scottish League Cup - Group F 2016/17,East Stirlingshire,4,0,0,4,1,11,-10,0
Scottish League Cup - Group G 2016/17,Hamilton Academical,4,3,0,1,10,5,5,9
Scottish League Cup - Group G 2016/17,Ayr United,4,3,0,1,5,2,3,9
Scottish League Cup - Group G 2016/17,St Mirren,4,3,0,1,7,5,2,9
Scottish League Cup - Group G 2016/17,Livingston,4,1,0,3,6,7,-1,3
Scottish League Cup - Group G 2016/17,Edinburgh City,4,0,0,4,2,11,-9,0
Scottish League Cup - Group H 2016/17,Morton,4,3,1,0,5,0,5,11
Scottish League Cup - Group H 2016/17,Kilmarnock,4,2,1,1,5,5,0,7
Scottish League Cup - Group H 2016/17,Clyde,4,1,1,2,4,5,-1,5
Scottish League Cup - Group H 2016/17,Albion Rovers,4,0,3,1,1,2,-1,5
Scottish League Cup - Group H 2016/17,Berwick Rangers,4,0,2,2,3,6,-3,2
Scottish League Cup - Group A 2017/18,Falkirk,4,4,0,0,13,1,12,12
Scottish League Cup - Group A 2017/18,Inverness CT,4,2,1,1,5,3,2,8
Scottish League Cup - Group A 2017/18,Stirling Albion,4,2,1,1,6,5,1,7
Scottish League Cup - Group A 2017/18,Brechin City,4,0,1,3,1,9,-8,2
Scottish League Cup - Group A 2017/18,Forfar Athletic,4,0,1,3,3,10,-7,1
Scottish League Cup - Group B 2017/18,Dunfermline Athletic,4,2,2,0,13,3,10,10
Scottish League Cup - Group B 2017/18,Peterhead,4,3,0,1,7,6,1,9
Scottish League Cup - Group B 2017/18,Hearts,4,2,1,1,7,4,3,7
Scottish League Cup - Group B 2017/18,East Fife,4,1,1,2,3,6,-3,4
Scottish League Cup - Group B 2017/18,Elgin City,4,0,0,4,2,13,-11,0
Scottish League Cup - Group C 2017/18,Dundee United,4,3,1,0,10,2,8,11
Scottish League Cup - Group C 2017/18,Dundee,4,3,1,0,8,2,6,10
Scottish League Cup - Group C 2017/18,Raith Rovers,4,2,0,2,9,5,4,6
Scottish League Cup - Group C 2017/18,Cowdenbeath,4,1,0,3,5,11,-6,3
Scottish League Cup - Group C 2017/18,Buckie,4,0,0,4,3,15,-12,0
Scottish League Cup - Group D 2017/18,Hibernian,4,3,1,0,13,1,12,10
Scottish League Cup - Group D 2017/18,Ross County,4,2,2,0,8,0,8,10
Scottish League Cup - Group D 2017/18,Arbroath,4,1,2,1,6,7,-1,6
Scottish League Cup - Group D 2017/18,Montrose,4,1,0,3,2,15,-13,3
Scottish League Cup - Group D 2017/18,Alloa Athletic,4,0,1,3,2,8,-6,1
Scottish League Cup - Group E 2017/18,Ayr United,4,4,0,0,15,3,12,12
Scottish League Cup - Group E 2017/18,Kilmarnock,4,3,0,1,9,3,6,9
Scottish League Cup - Group E 2017/18,Clyde,4,2,0,2,7,11,-4,6
Scottish League Cup - Group E 2017/18,Annan Athletic,4,0,1,3,2,10,-8,2
Scottish League Cup - Group E 2017/18,Dumbarton,4,0,1,3,2,8,-6,1
Scottish League Cup - Group F 2017/18,Motherwell,4,4,0,0,12,2,10,12
Scottish League Cup - Group F 2017/18,Morton,4,2,1,1,8,6,2,8
Scottish League Cup - Group F 2017/18,Queen's Park,4,2,1,1,9,9,0,7
Scottish League Cup - Group F 2017/18,Edinburgh City,4,0,1,3,3,12,-9,2
Scottish League Cup - Group F 2017/18,Berwick Rangers,4,0,1,3,4,7,-3,1
Scottish League Cup - Group G 2017/18,Hamilton Academical,4,2,2,0,11,6,5,9
Scottish League Cup - Group G 2017/18,Albion Rovers,4,1,3,0,12,9,3,7
Scottish League Cup - Group G 2017/18,Queen Of The South,4,1,3,0,6,4,2,7
Scottish League Cup - Group G 2017/18,East Kilbride,4,1,1,2,5,9,-4,5
Scottish League Cup - Group G 2017/18,Stenhousemuir,4,0,1,3,3,9,-6,2
Scottish League Cup - Group H 2017/18,Livingston,4,3,1,0,8,3,5,11
Scottish League Cup - Group H 2017/18,Partick Thistle,4,3,1,0,9,2,7,10
Scottish League Cup - Group H 2017/18,St Mirren,4,2,0,2,9,7,2,6
Scottish League Cup - Group H 2017/18,Airdrieonians,4,1,0,3,4,10,-6,3
Scottish League Cup - Group H 2017/18,Stranraer,4,0,0,4,4,12,-8,0
Scottish League Cup - Group A 2018/19,Ross County,4,3,0,1,6,4,2,9
Scottish League Cup - Group A 2018/19,Arbroath,4,2,1,1,9,6,3,8
Scottish League Cup - Group A 2018/19,Alloa Athletic,4,2,1,1,8,5,3,8
Scottish League Cup - Group A 2018/19,Dundee United,4,1,2,1,6,3,3,5
Scottish League Cup - Group A 2018/19,Elgin City,4,0,0,4,0,11,-11,0
Scottish League Cup - Group B 2018/19,St. Johnstone,4,3,1,0,5,1,4,11
Scottish League Cup - Group B 2018/19,Falkirk,4,2,0,2,4,3,1,6
Scottish League Cup - Group B 2018/19,Montrose,4,2,0,2,3,4,-1,6
Scottish League Cup - Group B 2018/19,Forfar Athletic,4,1,1,2,5,7,-2,5
Scottish League Cup - Group B 2018/19,East Fife,4,0,2,2,2,4,-2,2
Scottish League Cup - Group C 2018/19,Hearts,4,3,1,0,13,2,11,9
Scottish League Cup - Group C 2018/19,Inverness CT,4,3,0,1,9,8,1,9
Scottish League Cup - Group C 2018/19,Cowdenbeath,4,2,0,2,5,10,-5,6
Scottish League Cup - Group C 2018/19,Cove Rangers,4,1,0,3,3,5,-2,3
Scottish League Cup - Group C 2018/19,Raith Rovers,4,0,1,3,2,7,-5,1
Scottish League Cup - Group D 2018/19,Dunfermline Athletic,4,4,0,0,14,2,12,12
Scottish League Cup - Group D 2018/19,Dundee,4,3,0,1,8,1,7,9
Scottish League Cup - Group D 2018/19,Brechin City,4,1,1,2,3,10,-7,4
Scottish League Cup - Group D 2018/19,Stirling Albion,4,1,0,3,4,9,-5,3
Scottish League Cup - Group D 2018/19,Peterhead,4,0,1,3,0,7,-7,2
Scottish League Cup - Group E 2018/19,Ayr United,4,4,0,0,12,1,11,12
Scottish League Cup - Group E 2018/19,Partick Thistle,4,3,0,1,6,3,3,9
Scottish League Cup - Group E 2018/19,Morton,4,2,0,2,9,5,4,6
Scottish League Cup - Group E 2018/19,Stenhousemuir,4,1,0,3,4,9,-5,3
Scottish League Cup - Group E 2018/19,Albion Rovers,4,0,0,4,0,13,-13,0
Scottish League Cup - Group F 2018/19,Livingston,4,3,1,0,5,1,4,11
Scottish League Cup - Group F 2018/19,Airdrieonians,4,2,1,1,9,4,5,7
Scottish League Cup - Group F 2018/19,Hamilton Academical,4,1,2,1,5,2,3,6
Scottish League Cup - Group F 2018/19,Annan Athletic,4,2,0,2,6,5,1,6
Scottish League Cup - Group F 2018/19,Berwick Rangers,4,0,0,4,0,13,-13,0
Scottish League Cup - Group G 2018/19,Motherwell,4,3,1,0,11,2,9,10
Scottish League Cup - Group G 2018/19,Queen Of The South,4,3,0,1,12,5,7,9
Scottish League Cup - Group G 2018/19,Edinburgh City,4,1,1,2,5,12,-7,5
Scottish League Cup - Group G 2018/19,Clyde,4,1,1,2,5,8,-3,4
Scottish League Cup - Group G 2018/19,Stranraer,4,0,1,3,7,13,-6,2
Scottish League Cup - Group H 2018/19,Kilmarnock,4,3,1,0,9,2,7,10
Scottish League Cup - Group H 2018/19,St Mirren,4,1,3,0,8,2,6,9
Scottish League Cup - Group H 2018/19,Dumbarton,4,1,1,2,3,10,-7,5
Scottish League Cup - Group H 2018/19,Queen's Park,4,1,1,2,2,4,-2,4
Scottish League Cup - Group H 2018/19,Spartans,4,0,2,2,3,7,-4,2
Scottish League Cup - Group A 2019/20,Hearts,4,2,2,0,6,3,3,9
Scottish League Cup - Group A 2019/20,East Fife,4,2,1,1,5,3,2,8
Scottish League Cup - Group A 2019/20,Dundee United,4,2,1,1,6,4,2,7
Scottish League Cup - Group A 2019/20,Stenhousemuir,4,1,0,3,4,6,-2,3
Scottish League Cup - Group A 2019/20,Cowdenbeath,4,1,0,3,2,7,-5,3
Scottish League Cup - Group B 2019/20,Ross County,4,4,0,0,12,2,10,12
Scottish League Cup - Group B 2019/20,Forfar Athletic,4,3,0,1,9,4,5,9
Scottish League Cup - Group B 2019/20,Montrose,4,1,1,2,4,9,-5,5
Scottish League Cup - Group B 2019/20,St. Johnstone,4,1,0,3,6,5,1,3
Scottish League Cup - Group B 2019/20,Brechin City,4,0,1,3,1,12,-11,1
Scottish League Cup - Group C 2019/20,Hibernian,4,3,1,0,8,1,7,11
Scottish League Cup - Group C 2019/20,Alloa Athletic,4,2,1,1,8,8,0,7
Scottish League Cup - Group C 2019/20,Arbroath,4,2,0,2,10,8,2,6
Scottish League Cup - Group C 2019/20,Elgin City,4,1,1,2,7,7,0,5
Scottish League Cup - Group C 2019/20,Stirling Albion,4,0,1,3,3,12,-9,1
Scottish League Cup - Group D 2019/20,Dundee,4,2,2,0,4,0,4,10
Scottish League Cup - Group D 2019/20,Inverness CT,4,2,1,1,7,4,3,7
Scottish League Cup - Group D 2019/20,Peterhead,4,1,2,1,3,4,-1,6
Scottish League Cup - Group D 2019/20,Cove Rangers,4,1,1,2,6,5,1,4
Scottish League Cup - Group D 2019/20,Raith Rovers,4,1,0,3,4,11,-7,3
Scottish League Cup - Group E 2019/20,Motherwell,4,4,0,0,13,0,13,12
Scottish League Cup - Group E 2019/20,Morton,4,2,1,1,14,8,6,8
Scottish League Cup - Group E 2019/20,Queen Of The South,4,1,2,1,10,10,0,6
Scottish League Cup - Group E 2019/20,Dumbarton,4,1,0,3,3,12,-9,3
Scottish League Cup - Group E 2019/20,Annan Athletic,4,0,1,3,3,13,-10,1
Scottish League Cup - Group F 2019/20,Partick Thistle,4,3,1,0,8,5,3,10
Scottish League Cup - Group F 2019/20,Hamilton Academical,4,2,2,0,8,5,3,9
Scottish League Cup - Group F 2019/20,Airdrieonians,4,1,1,2,7,8,-1,5
Scottish League Cup - Group F 2019/20,Queen's Park,4,0,3,1,4,5,-1,5
Scottish League Cup - Group F 2019/20,Clyde,4,0,1,3,6,10,-4,1
Scottish League Cup - Group G 2019/20,Livingston,4,3,1,0,10,3,7,11
Scottish League Cup - Group G 2019/20,Ayr United,4,2,1,1,12,5,7,7
Scottish League Cup - Group G 2019/20,Falkirk,4,2,1,1,6,3,3,7
Scottish League Cup - Group G 2019/20,Stranraer,4,1,1,2,9,5,4,5
Scottish League Cup - Group G 2019/20,Berwick Rangers,4,0,0,4,0,21,-21,0
Scottish League Cup - Group H 2019/20,Dunfermline Athletic,4,3,0,1,13,3,10,9
Scottish League Cup - Group H 2019/20,Albion Rovers,4,2,1,1,3,7,-4,7
Scottish League Cup - Group H 2019/20,St Mirren,4,1,2,1,3,3,0,6
Scottish League Cup - Group H 2019/20,East Kilbride,4,1,1,2,1,5,-4,5
Scottish League Cup - Group H 2019/20,Edinburgh City,4,1,0,3,2,4,-2,3
Scottish League Cup - Group A 2020/21,Hearts,3,3,0,0,5,1,4,9
Scottish League Cup - Group A 2020/21,East Fife,2,1,0,1,3,2,1,3
Scottish League Cup - Group A 2020/21,Raith Rovers,2,1,0,1,3,4,-1,3
Scottish League Cup - Group A 2020/21,Inverness CT,2,0,1,1,0,1,-1,2
Scottish League Cup - Group A 2020/21,Cowdenbeath,3,0,1,2,0,3,-3,1
Scottish League Cup - Group B 2020/21,Hibernian,3,3,0,0,6,2,4,9
Scottish League Cup - Group B 2020/21,Dundee,2,2,0,0,5,0,5,6
Scottish League Cup - Group B 2020/21,Cove Rangers,2,0,1,1,3,4,-1,2
Scottish League Cup - Group B 2020/21,Brora,3,0,1,2,3,7,-4,1
Scottish League Cup - Group B 2020/21,Forfar Athletic,2,0,0,2,0,4,-4,0
Scottish League Cup - Group C 2020/21,St. Johnstone,2,2,0,0,9,1,8,6
Scottish League Cup - Group C 2020/21,Dundee United,3,2,0,1,7,3,4,6
Scottish League Cup - Group C 2020/21,Peterhead,2,2,0,0,4,1,3,6
Scottish League Cup - Group C 2020/21,Kelty Hearts,2,0,0,2,1,3,-2,0
Scottish League Cup - Group C 2020/21,Brechin City,3,0,0,3,3,16,-13,0
Scottish League Cup - Group D 2020/21,Elgin City,2,2,0,0,4,0,4,6
Scottish League Cup - Group D 2020/21,Arbroath,3,2,0,1,6,4,2,6
Scottish League Cup - Group D 2020/21,Ross County,2,1,1,0,5,4,1,5
Scottish League Cup - Group D 2020/21,Montrose,3,0,1,2,4,8,-4,1
Scottish League Cup - Group D 2020/21,Stirling Albion,2,0,0,2,1,4,-3,0
Scottish League Cup - Group E 2020/21,Dunfermline Athletic,3,3,0,0,6,0,6,9
Scottish League Cup - Group E 2020/21,Falkirk,3,2,0,1,5,3,2,6
Scottish League Cup - Group E 2020/21,Clyde,2,1,0,1,4,4,0,3
Scottish League Cup - Group E 2020/21,Dumbarton,2,0,0,2,2,4,-2,0
Scottish League Cup - Group E 2020/21,Kilmarnock,2,0,0,2,0,6,-6,0
Scottish League Cup - Group F 2020/21,Ayr United,3,2,0,1,7,4,3,6
Scottish League Cup - Group F 2020/21,Annan Athletic,3,1,1,1,4,3,1,4
Scottish League Cup - Group F 2020/21,Stranraer,2,0,2,0,3,3,0,3
Scottish League Cup - Group F 2020/21,Hamilton Academical,2,1,0,1,3,4,-1,3
Scottish League Cup - Group F 2020/21,Albion Rovers,2,0,1,1,4,7,-3,2
Scottish League Cup - Group G 2020/21,St Mirren,2,1,1,0,6,3,3,5
Scottish League Cup - Group G 2020/21,Partick Thistle,3,1,1,1,3,4,-1,5
Scottish League Cup - Group G 2020/21,Morton,2,1,1,0,3,2,1,4
Scottish League Cup - Group G 2020/21,Queen Of The South,3,0,3,0,4,4,0,4
Scottish League Cup - Group G 2020/21,Queen's Park,2,0,0,2,0,3,-3,0
Scottish League Cup - Group H 2020/21,Livingston,2,2,0,0,7,2,5,6
Scottish League Cup - Group H 2020/21,Alloa Athletic,3,2,0,1,5,3,2,6
Scottish League Cup - Group H 2020/21,Airdrieonians,2,1,0,1,2,2,0,3
Scottish League Cup - Group H 2020/21,Stenhousemuir,2,0,1,1,2,4,-2,2
Scottish League Cup - Group H 2020/21,Edinburgh City,3,0,1,2,4,9,-5,1
The Irn-Bru Scottish Football League Championship Second Division 2009/10,Stirling Albion,36,18,11,7,68,48,20,65
The Irn-Bru Scottish Football League Championship Second Division 2009/10,Alloa Athletic,36,19,8,9,49,35,14,65
The Irn-Bru Scottish Football League Championship Second Division 2009/10,Cowdenbeath,36,16,11,9,60,41,19,59
The Irn-Bru Scottish Football League Championship Second Division 2009/10,Brechin City,36,15,9,12,50,45,5,54
The Irn-Bru Scottish Football League Championship Second Division 2009/10,Peterhead,36,15,6,15,45,49,-4,51
The Irn-Bru Scottish Football League Championship Second Division 2009/10,Dumbarton,36,14,6,16,49,58,-9,48
The Irn-Bru Scottish Football League Championship Second Division 2009/10,East Fife,36,10,11,15,46,53,-7,41
The Irn-Bru Scottish Football League Championship Second Division 2009/10,Stenhousemuir,36,9,13,14,38,42,-4,40
The Irn-Bru Scottish Football League Championship Second Division 2009/10,Arbroath,36,10,10,16,41,55,-14,40
The Irn-Bru Scottish Football League Championship Second Division 2009/10,Clyde,36,8,7,21,37,57,-20,31
The Irn-Bru Scottish Football League Championship Second Division 2010/11,Livingston,36,25,7,4,79,33,46,82
The Irn-Bru Scottish Football League Championship Second Division 2010/11,Ayr United,36,18,5,13,62,55,7,59
The Irn-Bru Scottish Football League Championship Second Division 2010/11,Forfar Athletic,36,17,8,11,50,48,2,59
The Irn-Bru Scottish Football League Championship Second Division 2010/11,Brechin City,36,15,12,9,63,45,18,57
The Irn-Bru Scottish Football League Championship Second Division 2010/11,East Fife,36,14,10,12,77,60,17,52
The Irn-Bru Scottish Football League Championship Second Division 2010/11,Airdrieonians,36,13,9,14,52,60,-8,48
The Irn-Bru Scottish Football League Championship Second Division 2010/11,Dumbarton,36,11,7,18,52,70,-18,40
The Irn-Bru Scottish Football League Championship Second Division 2010/11,Stenhousemuir,36,10,8,18,46,59,-13,38
The Irn-Bru Scottish Football League Championship Second Division 2010/11,Alloa Athletic,36,9,9,18,49,71,-22,36
The Irn-Bru Scottish Football League Championship Second Division 2010/11,Peterhead,36,5,11,20,47,76,-29,26
The Irn-Bru Scottish Football League Championship Second Division 2011/12,Cowdenbeath,36,20,11,5,68,29,39,71
The Irn-Bru Scottish Football League Championship Second Division 2011/12,Arbroath,36,17,12,7,76,51,25,63
The Irn-Bru Scottish Football League Championship Second Division 2011/12,Dumbarton,36,17,7,12,61,61,0,58
The Irn-Bru Scottish Football League Championship Second Division 2011/12,Airdrieonians,36,14,10,12,68,60,8,52
The Irn-Bru Scottish Football League Championship Second Division 2011/12,Stenhousemuir,36,15,6,15,54,49,5,51
The Irn-Bru Scottish Football League Championship Second Division 2011/12,East Fife,36,14,6,16,55,57,-2,48
The Irn-Bru Scottish Football League Championship Second Division 2011/12,Forfar Athletic,36,11,9,16,59,72,-13,42
The Irn-Bru Scottish Football League Championship Second Division 2011/12,Brechin City,36,10,11,15,47,62,-15,41
The Irn-Bru Scottish Football League Championship Second Division 2011/12,Albion Rovers,36,10,7,19,43,66,-23,37
The Irn-Bru Scottish Football League Championship Second Division 2011/12,Stirling Albion,36,9,7,20,46,70,-24,34
The Irn-Bru Scottish Second Division 2012/13,Queen Of The South,36,29,5,2,92,23,69,92
The Irn-Bru Scottish Second Division 2012/13,Alloa Athletic,36,20,7,9,62,35,27,67
The Irn-Bru Scottish Second Division 2012/13,Brechin City,36,19,4,13,72,59,13,61
The Irn-Bru Scottish Second Division 2012/13,Forfar Athletic,36,17,3,16,67,74,-7,54
The Irn-Bru Scottish Second Division 2012/13,Arbroath,36,15,7,14,47,57,-10,52
The Irn-Bru Scottish Second Division 2012/13,Stenhousemuir,36,12,13,11,59,59,0,49
The Irn-Bru Scottish Second Division 2012/13,Ayr United,36,12,5,19,53,65,-12,41
The Irn-Bru Scottish Second Division 2012/13,Stranraer,36,10,7,19,43,71,-28,37
The Irn-Bru Scottish Second Division 2012/13,East Fife,36,8,8,20,50,65,-15,32
The Irn-Bru Scottish Second Division 2012/13,Albion Rovers,36,7,3,26,45,82,-37,24
Scottish League One 2013/14,Rangers,36,33,3,0,106,18,88,102
Scottish League One 2013/14,Dunfermline Athletic,36,19,6,11,68,54,14,63
Scottish League One 2013/14,Stranraer,36,14,9,13,57,57,0,51
Scottish League One 2013/14,Ayr United,36,14,7,15,65,66,-1,49
Scottish League One 2013/14,Stenhousemuir,36,12,12,12,57,66,-9,48
Scottish League One 2013/14,Airdrieonians,36,12,9,15,47,57,-10,45
Scottish League One 2013/14,Forfar Athletic,36,12,7,17,55,62,-7,43
Scottish League One 2013/14,Brechin City,36,12,6,18,57,71,-14,42
Scottish League One 2013/14,East Fife,36,9,5,22,31,69,-38,32
Scottish League One 2013/14,Arbroath,36,9,4,23,52,75,-23,31
Scottish League One 2014/15,Morton,36,22,3,11,65,40,25,69
Scottish League One 2014/15,Stranraer,36,20,7,9,59,38,21,67
Scottish League One 2014/15,Forfar Athletic,36,20,6,10,59,41,18,66
Scottish League One 2014/15,Brechin City,36,15,14,7,58,46,12,59
Scottish League One 2014/15,Airdrieonians,36,16,10,10,53,39,14,58
Scottish League One 2014/15,Peterhead,36,14,9,13,51,54,-3,51
Scottish League One 2014/15,Dunfermline Athletic,36,13,9,14,46,48,-2,48
Scottish League One 2014/15,Ayr United,36,9,7,20,45,60,-15,34
Scottish League One 2014/15,Stenhousemuir,36,8,5,23,42,63,-21,29
Scottish League One 2014/15,Stirling Albion,36,4,8,24,35,84,-49,20
Scottish League One 2015/16,Dunfermline Athletic,36,24,7,5,83,30,53,79
Scottish League One 2015/16,Ayr United,36,19,4,13,65,47,18,61
Scottish League One 2015/16,Peterhead,36,16,11,9,72,47,25,59
Scottish League One 2015/16,Stranraer,36,15,6,15,43,49,-6,51
Scottish League One 2015/16,Airdrieonians,36,14,7,15,48,50,-2,49
Scottish League One 2015/16,Albion Rovers,36,13,10,13,40,44,-4,49
Scottish League One 2015/16,Brechin City,36,12,6,18,47,59,-12,42
Scottish League One 2015/16,Stenhousemuir,36,11,7,18,46,80,-34,40
Scottish League One 2015/16,Cowdenbeath,36,11,6,19,46,72,-26,39
Scottish League One 2015/16,Forfar Athletic,36,8,10,18,48,60,-12,34
Scottish League 1 2016/17,Livingston,36,26,3,7,80,32,48,81
Scottish League 1 2016/17,Alloa Athletic,36,17,11,8,69,44,25,62
Scottish League 1 2016/17,Airdrieonians,36,16,4,16,61,66,-5,52
Scottish League 1 2016/17,Brechin City,36,15,5,16,43,49,-6,50
Scottish League 1 2016/17,East Fife,36,12,10,14,41,44,-3,46
Scottish League 1 2016/17,Queen's Park,36,12,10,14,37,51,-14,46
Scottish League 1 2016/17,Stranraer,36,12,8,16,46,50,-4,44
Scottish League 1 2016/17,Albion Rovers,36,11,9,16,41,48,-7,42
Scottish League 1 2016/17,Peterhead,36,10,10,16,44,59,-15,40
Scottish League 1 2016/17,Stenhousemuir,36,11,6,19,45,64,-19,39
Scottish League 1 2017/18,Ayr United,36,24,4,8,92,42,50,76
Scottish League 1 2017/18,Raith Rovers,36,22,9,5,68,32,36,75
Scottish League 1 2017/18,Alloa Athletic,36,17,9,10,56,43,13,60
Scottish League 1 2017/18,Arbroath,36,17,8,11,70,51,19,59
Scottish League 1 2017/18,Stranraer,36,16,5,15,58,66,-8,53
Scottish League 1 2017/18,East Fife,36,13,3,20,49,67,-18,42
Scottish League 1 2017/18,Airdrieonians,36,10,11,15,46,60,-14,41
Scottish League 1 2017/18,Forfar Athletic,36,11,5,20,40,65,-25,38
Scottish League 1 2017/18,Queen's Park,36,7,10,19,42,72,-30,31
Scottish League 1 2017/18,Albion Rovers,36,8,6,22,57,80,-23,30
Scottish League 1 2018/19,Arbroath,36,20,10,6,63,38,25,70
Scottish League 1 2018/19,Forfar Athletic,36,19,6,11,54,47,7,63
Scottish League 1 2018/19,Raith Rovers,36,16,12,8,75,49,26,60
Scottish League 1 2018/19,Montrose,36,15,6,15,49,50,-1,51
Scottish League 1 2018/19,Airdrieonians,36,14,6,16,51,44,7,48
Scottish League 1 2018/19,Dumbarton,36,12,10,14,60,60,0,46
Scottish League 1 2018/19,East Fife,36,13,7,16,49,56,-7,46
Scottish League 1 2018/19,Stranraer,36,11,9,16,45,57,-12,42
Scottish League 1 2018/19,Stenhousemuir,36,10,7,19,35,61,-26,37
Scottish League 1 2018/19,Brechin City,36,9,9,18,42,61,-19,36
Scottish League 1 2019/20,Raith Rovers,28,15,8,5,49,33,16,53
Scottish League 1 2019/20,Falkirk,28,14,10,4,54,18,36,52
Scottish League 1 2019/20,Airdrieonians,28,14,6,8,38,27,11,48
Scottish League 1 2019/20,Montrose,28,15,2,11,48,38,10,47
Scottish League 1 2019/20,East Fife,28,12,9,7,44,36,8,45
Scottish League 1 2019/20,Dumbarton,28,11,5,12,35,44,-9,38
Scottish League 1 2019/20,Clyde,28,9,7,12,35,43,-8,34
Scottish League 1 2019/20,Peterhead,27,7,5,15,30,44,-14,26
Scottish League 1 2019/20,Forfar Athletic,28,6,6,16,26,47,-21,24
Scottish League 1 2019/20,Stranraer,27,2,10,15,28,57,-29,16
Scottish League 1 2020/21,Cove Rangers,3,3,0,0,6,1,5,9
Scottish League 1 2020/21,Falkirk,3,2,1,0,6,2,4,7
Scottish League 1 2020/21,Dumbarton,2,1,1,0,2,0,2,4
Scottish League 1 2020/21,Montrose,3,1,1,1,6,7,-1,4
Scottish League 1 2020/21,Airdrieonians,3,1,0,2,3,4,-1,3
Scottish League 1 2020/21,Partick Thistle,3,1,0,2,2,3,-1,3
Scottish League 1 2020/21,Clyde,2,1,0,1,1,2,-1,3
Scottish League 1 2020/21,Peterhead,3,1,0,2,2,4,-2,3
Scottish League 1 2020/21,Forfar Athletic,3,0,2,1,3,4,-1,2
Scottish League 1 2020/21,East Fife,3,0,1,2,3,7,-4,1
The Irn-Bru Scottish Football League Championship Third Division 2009/10,Livingston,36,24,6,6,63,25,38,78
The Irn-Bru Scottish Football League Championship Third Division 2009/10,Forfar Athletic,36,18,9,9,59,44,15,63
The Irn-Bru Scottish Football League Championship Third Division 2009/10,East Stirlingshire,36,19,4,13,50,46,4,61
The Irn-Bru Scottish Football League Championship Third Division 2009/10,Queen's Park,36,15,6,15,42,42,0,51
The Irn-Bru Scottish Football League Championship Third Division 2009/10,Albion Rovers,36,13,11,12,35,35,0,50
The Irn-Bru Scottish Football League Championship Third Division 2009/10,Berwick Rangers,36,14,8,14,46,50,-4,50
The Irn-Bru Scottish Football League Championship Third Division 2009/10,Stranraer,36,13,8,15,48,54,-6,47
The Irn-Bru Scottish Football League Championship Third Division 2009/10,Annan Athletic,36,11,10,15,41,42,-1,43
The Irn-Bru Scottish Football League Championship Third Division 2009/10,Elgin City,36,9,7,20,46,59,-13,34
The Irn-Bru Scottish Football League Championship Third Division 2009/10,Montrose,36,5,9,22,30,63,-33,24
The Irn-Bru Scottish Football League Championship Third Division 2010/11,Arbroath,36,20,6,10,80,61,19,66
The Irn-Bru Scottish Football League Championship Third Division 2010/11,Albion Rovers,36,17,10,9,56,40,16,61
The Irn-Bru Scottish Football League Championship Third Division 2010/11,Queen's Park,36,18,5,13,57,43,14,59
The Irn-Bru Scottish Football League Championship Third Division 2010/11,Annan Athletic,36,16,11,9,58,45,13,59
The Irn-Bru Scottish Football League Championship Third Division 2010/11,Stranraer,36,15,12,9,72,57,15,57
The Irn-Bru Scottish Football League Championship Third Division 2010/11,Berwick Rangers,36,12,13,11,62,56,6,49
The Irn-Bru Scottish Football League Championship Third Division 2010/11,Elgin City,36,13,6,17,53,63,-10,45
The Irn-Bru Scottish Football League Championship Third Division 2010/11,Montrose,36,10,7,19,47,61,-14,37
The Irn-Bru Scottish Football League Championship Third Division 2010/11,East Stirlingshire,36,10,4,22,33,62,-29,34
The Irn-Bru Scottish Football League Championship Third Division 2010/11,Clyde,36,8,8,20,37,67,-30,32
The Irn-Bru Scottish Football League Championship Third Division 2011/12,Alloa Athletic,36,23,8,5,70,39,31,77
The Irn-Bru Scottish Football League Championship Third Division 2011/12,Queen's Park,36,19,6,11,70,48,22,63
The Irn-Bru Scottish Football League Championship Third Division 2011/12,Stranraer,36,17,7,12,77,57,20,58
The Irn-Bru Scottish Football League Championship Third Division 2011/12,Elgin City,36,16,9,11,68,60,8,57
The Irn-Bru Scottish Football League Championship Third Division 2011/12,Peterhead,36,15,6,15,51,53,-2,51
The Irn-Bru Scottish Football League Championship Third Division 2011/12,Annan Athletic,36,13,10,13,53,53,0,49
The Irn-Bru Scottish Football League Championship Third Division 2011/12,Berwick Rangers,36,12,12,12,61,58,3,48
The Irn-Bru Scottish Football League Championship Third Division 2011/12,Montrose,36,11,5,20,58,75,-17,38
The Irn-Bru Scottish Football League Championship Third Division 2011/12,Clyde,36,8,11,17,35,50,-15,35
The Irn-Bru Scottish Football League Championship Third Division 2011/12,East Stirlingshire,36,6,6,24,38,88,-50,24
The Irn-Bru Scottish Third Division 2012/13,Rangers,36,25,8,3,87,29,58,83
The Irn-Bru Scottish Third Division 2012/13,Peterhead,36,17,8,11,52,28,24,59
The Irn-Bru Scottish Third Division 2012/13,Queen's Park,36,16,8,12,60,54,6,56
The Irn-Bru Scottish Third Division 2012/13,Berwick Rangers,36,14,7,15,59,55,4,49
The Irn-Bru Scottish Third Division 2012/13,Elgin City,36,13,10,13,67,69,-2,49
The Irn-Bru Scottish Third Division 2012/13,Montrose,36,12,11,13,60,68,-8,47
The Irn-Bru Scottish Third Division 2012/13,Stirling Albion,36,12,9,15,59,58,1,45
The Irn-Bru Scottish Third Division 2012/13,Annan Athletic,36,11,10,15,54,65,-11,43
The Irn-Bru Scottish Third Division 2012/13,Clyde,36,12,4,20,42,66,-24,40
The Irn-Bru Scottish Third Division 2012/13,East Stirlingshire,36,8,5,23,49,97,-48,29
Scottish League Two 2013/14,Peterhead,36,23,7,6,74,38,36,76
Scottish League Two 2013/14,Annan Athletic,36,19,6,11,69,49,20,63
Scottish League Two 2013/14,Stirling Albion,36,16,10,10,60,50,10,58
Scottish League Two 2013/14,Clyde,36,17,6,13,50,48,2,57
Scottish League Two 2013/14,Berwick Rangers,36,15,7,14,63,49,14,52
Scottish League Two 2013/14,Montrose,36,12,10,14,44,56,-12,46
Scottish League Two 2013/14,Albion Rovers,36,12,8,16,41,54,-13,44
Scottish League Two 2013/14,East Stirlingshire,36,12,8,16,45,59,-14,44
Scottish League Two 2013/14,Elgin City,36,9,9,18,62,73,-11,36
Scottish League Two 2013/14,Queen's Park,36,5,9,22,36,68,-32,24
Scottish League Two 2014/15,Albion Rovers,36,22,5,9,61,33,28,71
Scottish League Two 2014/15,Queen's Park,36,17,10,9,51,34,17,61
Scottish League Two 2014/15,Arbroath,36,16,8,12,65,46,19,56
Scottish League Two 2014/15,East Fife,36,15,8,13,56,48,8,53
Scottish League Two 2014/15,Annan Athletic,36,14,8,14,56,56,0,50
Scottish League Two 2014/15,Clyde,36,13,8,15,40,50,-10,47
Scottish League Two 2014/15,Elgin City,36,12,9,15,55,58,-3,45
Scottish League Two 2014/15,Berwick Rangers,36,11,10,15,60,57,3,43
Scottish League Two 2014/15,East Stirlingshire,36,13,4,19,40,66,-26,43
Scottish League Two 2014/15,Montrose,36,9,6,21,42,78,-36,33
Scottish League Two 2015/16,East Fife,36,18,8,10,62,41,21,62
Scottish League Two 2015/16,Elgin City,36,17,8,11,59,46,13,59
Scottish League Two 2015/16,Clyde,36,17,6,13,56,45,11,57
Scottish League Two 2015/16,Queen's Park,36,15,11,10,46,32,14,56
Scottish League Two 2015/16,Annan Athletic,36,16,8,12,69,57,12,56
Scottish League Two 2015/16,Berwick Rangers,36,14,7,15,45,50,-5,49
Scottish League Two 2015/16,Stirling Albion,36,13,9,14,47,46,1,48
Scottish League Two 2015/16,Montrose,36,11,10,15,50,70,-20,43
Scottish League Two 2015/16,Arbroath,36,11,6,19,42,51,-9,39
Scottish League Two 2015/16,East Stirlingshire,36,9,5,22,41,79,-38,32
Scottish League 2 2016/17,Arbroath,36,18,12,6,63,36,27,66
Scottish League 2 2016/17,Forfar Athletic,36,18,10,8,69,49,20,64
Scottish League 2 2016/17,Annan Athletic,36,18,4,14,61,58,3,58
Scottish League 2 2016/17,Montrose,36,14,10,12,44,53,-9,52
Scottish League 2 2016/17,Elgin City,36,14,9,13,67,47,20,51
Scottish League 2 2016/17,Stirling Albion,36,12,11,13,50,59,-9,47
Scottish League 2 2016/17,Edinburgh City,36,11,10,15,38,45,-7,43
Scottish League 2 2016/17,Berwick Rangers,36,10,10,16,50,65,-15,40
Scottish League 2 2016/17,Clyde,36,10,8,18,49,64,-15,38
Scottish League 2 2016/17,Cowdenbeath,36,9,8,19,40,55,-15,35
Scottish League 2 2017/18,Montrose,36,23,8,5,60,35,25,77
Scottish League 2 2017/18,Peterhead,36,24,4,8,79,39,40,76
Scottish League 2 2017/18,Stirling Albion,36,16,7,13,61,52,9,55
Scottish League 2 2017/18,Stenhousemuir,36,15,9,12,56,47,9,54
Scottish League 2 2017/18,Clyde,36,14,9,13,52,50,2,51
Scottish League 2 2017/18,Elgin City,36,14,7,15,54,61,-7,49
Scottish League 2 2017/18,Annan Athletic,36,12,11,13,49,41,8,47
Scottish League 2 2017/18,Berwick Rangers,36,9,10,17,31,59,-28,37
Scottish League 2 2017/18,Edinburgh City,36,7,9,20,37,62,-25,30
Scottish League 2 2017/18,Cowdenbeath,36,4,10,22,23,56,-33,22
Scottish League 2 2018/19,Peterhead,36,24,7,5,65,29,36,79
Scottish League 2 2018/19,Clyde,36,23,5,8,63,35,28,74
Scottish League 2 2018/19,Edinburgh City,36,20,7,9,58,31,27,67
Scottish League 2 2018/19,Annan Athletic,36,20,6,10,70,39,31,66
Scottish League 2 2018/19,Stirling Albion,36,13,8,15,44,45,-1,47
Scottish League 2 2018/19,Cowdenbeath,36,12,7,17,46,46,0,43
Scottish League 2 2018/19,Queen's Park,36,11,10,15,44,47,-3,43
Scottish League 2 2018/19,Elgin City,36,13,4,19,52,67,-15,43
Scottish League 2 2018/19,Albion Rovers,36,7,6,23,32,71,-39,27
Scottish League 2 2018/19,Berwick Rangers,36,5,4,27,27,91,-64,19
Scottish League 2 2019/20,Cove Rangers,28,22,2,4,76,34,42,68
Scottish League 2 2019/20,Edinburgh City,27,17,4,6,49,28,21,55
Scottish League 2 2019/20,Elgin City,28,12,7,9,48,34,14,43
Scottish League 2 2019/20,Cowdenbeath,27,12,5,10,37,35,2,41
Scottish League 2 2019/20,Queen's Park,28,11,7,10,37,35,2,40
Scottish League 2 2019/20,Stirling Albion,28,10,6,12,34,35,-1,36
Scottish League 2 2019/20,Annan Athletic,27,9,4,14,33,54,-21,31
Scottish League 2 2019/20,Stenhousemuir,28,7,8,13,32,48,-16,29
Scottish League 2 2019/20,Albion Rovers,26,6,6,14,37,51,-14,24
Scottish League 2 2019/20,Brechin City,27,4,5,18,31,60,-29,17
Scottish League 2 2020/21,Queen's Park,3,2,1,0,3,0,3,7
Scottish League 2 2020/21,Elgin City,3,2,0,1,7,2,5,6
Scottish League 2 2020/21,Edinburgh City,3,2,0,1,6,2,4,6
Scottish League 2 2020/21,Stenhousemuir,3,1,2,0,6,4,2,5
Scottish League 2 2020/21,Stirling Albion,3,1,2,0,3,2,1,5
Scottish League 2 2020/21,Annan Athletic,3,1,1,1,4,2,2,4
Scottish League 2 2020/21,Cowdenbeath,3,1,1,1,2,4,-2,4
Scottish League 2 2020/21,Brechin City,3,1,0,2,3,8,-5,3
Scottish League 2 2020/21,Stranraer,3,0,1,2,2,6,-4,1
Scottish League 2 2020/21,Albion Rovers,3,0,0,3,1,7,-6,0
Clydesdale Bank Premier League 2009/10,Rangers,38,26,9,3,82,28,54,87
Clydesdale Bank Premier League 2009/10,Celtic,38,25,6,7,75,39,36,81
Clydesdale Bank Premier League 2009/10,Dundee United,38,17,12,9,55,47,8,63
Clydesdale Bank Premier League 2009/10,Hibernian,38,15,9,14,58,55,3,54
Clydesdale Bank Premier League 2009/10,Motherwell,38,13,14,11,52,54,-2,53
Clydesdale Bank Premier League 2009/10,Hearts,38,13,9,16,35,46,-11,48
Clydesdale Bank Premier League 2009/10,Hamilton Academical,38,13,10,15,39,46,-7,49
Clydesdale Bank Premier League 2009/10,St. Johnstone,38,12,11,15,57,61,-4,47
Clydesdale Bank Premier League 2009/10,Aberdeen,38,10,11,17,36,52,-16,41
Clydesdale Bank Premier League 2009/10,St Mirren,38,7,13,18,36,49,-13,34
Clydesdale Bank Premier League 2009/10,Kilmarnock,38,8,9,21,29,51,-22,33
Clydesdale Bank Premier League 2009/10,Falkirk,38,6,13,19,31,57,-26,31
Clydesdale Bank Premier League 2010/11,Rangers,38,30,3,5,88,29,59,93
Clydesdale Bank Premier League 2010/11,Celtic,38,29,5,4,85,22,63,92
Clydesdale Bank Premier League 2010/11,Hearts,38,18,9,11,53,45,8,63
Clydesdale Bank Premier League 2010/11,Dundee United,38,17,10,11,55,50,5,61
Clydesdale Bank Premier League 2010/11,Kilmarnock,38,13,10,15,53,55,-2,49
Clydesdale Bank Premier League 2010/11,Motherwell,38,13,7,18,40,60,-20,46
Clydesdale Bank Premier League 2010/11,Inverness CT,38,14,11,13,52,44,8,53
Clydesdale Bank Premier League 2010/11,St. Johnstone,38,11,11,16,23,43,-20,44
Clydesdale Bank Premier League 2010/11,Aberdeen,38,11,5,22,39,59,-20,38
Clydesdale Bank Premier League 2010/11,Hibernian,38,10,7,21,39,61,-22,37
Clydesdale Bank Premier League 2010/11,St Mirren,38,8,9,21,33,57,-24,33
Clydesdale Bank Premier League 2010/11,Hamilton Academical,38,5,11,22,24,59,-35,26
Clydesdale Bank Premier League 2011/12,Celtic,38,30,3,5,84,21,63,93
Clydesdale Bank Premier League 2011/12,Rangers *,38,26,5,7,77,28,49,73
Clydesdale Bank Premier League 2011/12,Motherwell,38,18,8,12,49,44,5,62
Clydesdale Bank Premier League 2011/12,Dundee United,38,16,11,11,62,50,12,59
Clydesdale Bank Premier League 2011/12,Hearts,38,15,7,16,45,43,2,52
Clydesdale Bank Premier League 2011/12,St. Johnstone,38,14,8,16,43,50,-7,50
Clydesdale Bank Premier League 2011/12,Kilmarnock,38,11,14,13,44,61,-17,47
Clydesdale Bank Premier League 2011/12,St Mirren,38,9,16,13,39,51,-12,43
Clydesdale Bank Premier League 2011/12,Aberdeen,38,9,14,15,36,44,-8,41
Clydesdale Bank Premier League 2011/12,Inverness CT,38,10,9,19,42,60,-18,39
Clydesdale Bank Premier League 2011/12,Hibernian,38,8,9,21,40,67,-27,33
Clydesdale Bank Premier League 2011/12,Dunfermline Athletic,38,5,10,23,40,82,-42,25
Clydesdale Bank Premier League 2012/13,Celtic,38,24,7,7,92,35,57,79
Clydesdale Bank Premier League 2012/13,Motherwell,38,18,9,11,67,51,16,63
Clydesdale Bank Premier League 2012/13,St. Johnstone,38,14,14,10,45,44,1,56
Clydesdale Bank Premier League 2012/13,Inverness CT,38,13,15,10,64,60,4,54
Clydesdale Bank Premier League 2012/13,Ross County,38,13,14,11,47,48,-1,53
Clydesdale Bank Premier League 2012/13,Dundee United,38,11,14,13,51,62,-11,47
Clydesdale Bank Premier League 2012/13,Hibernian,38,13,12,13,49,52,-3,51
Clydesdale Bank Premier League 2012/13,Aberdeen,38,11,15,12,41,43,-2,48
Clydesdale Bank Premier League 2012/13,Kilmarnock,38,11,12,15,52,53,-1,45
Clydesdale Bank Premier League 2012/13,Hearts,38,11,11,16,40,49,-9,44
Clydesdale Bank Premier League 2012/13,St Mirren,38,9,14,15,47,60,-13,41
Clydesdale Bank Premier League 2012/13,Dundee,38,7,9,22,28,66,-38,30
Scottish Premiership 2013/14,Celtic,38,31,6,1,102,25,77,99
Scottish Premiership 2013/14,Motherwell,38,22,4,12,64,60,4,70
Scottish Premiership 2013/14,Aberdeen,38,20,8,10,53,38,15,68
Scottish Premiership 2013/14,Dundee United,38,16,10,12,65,50,15,58
Scottish Premiership 2013/14,Inverness CT,38,16,9,13,44,44,0,57
Scottish Premiership 2013/14,St. Johnstone,38,15,8,15,48,42,6,53
Scottish Premiership 2013/14,Ross County,38,11,7,20,44,62,-18,40
Scottish Premiership 2013/14,St Mirren,38,10,9,19,39,58,-19,39
Scottish Premiership 2013/14,Kilmarnock,38,11,6,21,45,66,-21,39
Scottish Premiership 2013/14,Partick Thistle,38,8,14,16,46,65,-19,38
Scottish Premiership 2013/14,Hibernian,38,8,11,19,31,51,-20,35
Scottish Premiership 2013/14,Hearts *,38,10,8,20,45,65,-20,23
Scottish Premiership 2014/15,Celtic,38,29,5,4,84,17,67,92
Scottish Premiership 2014/15,Aberdeen,38,23,6,9,57,33,24,75
Scottish Premiership 2014/15,Inverness CT,38,19,8,11,52,42,10,65
Scottish Premiership 2014/15,St. Johnstone,38,16,9,13,34,34,0,57
Scottish Premiership 2014/15,Dundee United,38,17,5,16,58,56,2,56
Scottish Premiership 2014/15,Dundee,38,11,12,15,46,57,-11,45
Scottish Premiership 2014/15,Hamilton Academical,38,15,8,15,50,53,-3,53
Scottish Premiership 2014/15,Partick Thistle,38,12,10,16,48,44,4,46
Scottish Premiership 2014/15,Ross County,38,12,8,18,46,63,-17,44
Scottish Premiership 2014/15,Kilmarnock,38,11,8,19,44,59,-15,41
Scottish Premiership 2014/15,Motherwell,38,10,6,22,38,63,-25,36
Scottish Premiership 2014/15,St Mirren,38,9,3,26,30,66,-36,30
Scottish Premiership 2015/16,Celtic,38,26,8,4,93,31,62,86
Scottish Premiership 2015/16,Aberdeen,38,22,5,11,62,48,14,71
Scottish Premiership 2015/16,Hearts,38,18,11,9,59,40,19,65
Scottish Premiership 2015/16,St. Johnstone,38,16,8,14,58,55,3,56
Scottish Premiership 2015/16,Motherwell,38,15,5,18,47,63,-16,50
Scottish Premiership 2015/16,Ross County,38,14,6,18,55,61,-6,48
Scottish Premiership 2015/16,Inverness CT,38,14,10,14,54,48,6,52
Scottish Premiership 2015/16,Dundee,38,11,15,12,53,57,-4,48
Scottish Premiership 2015/16,Partick Thistle,38,12,10,16,41,50,-9,46
Scottish Premiership 2015/16,Hamilton Academical,38,11,10,17,42,63,-21,43
Scottish Premiership 2015/16,Kilmarnock,38,9,9,20,41,64,-23,36
Scottish Premiership 2015/16,Dundee United *,38,8,7,23,45,70,-25,28
Scottish Premiership 2016/17,Celtic,38,34,4,0,106,25,81,106
Scottish Premiership 2016/17,Aberdeen,38,24,4,10,74,35,39,76
Scottish Premiership 2016/17,Rangers,38,19,10,9,56,44,12,67
Scottish Premiership 2016/17,St. Johnstone,38,17,7,14,50,46,4,58
Scottish Premiership 2016/17,Hearts,38,12,10,16,55,52,3,46
Scottish Premiership 2016/17,Partick Thistle,38,10,12,16,38,54,-16,42
Scottish Premiership 2016/17,Ross County,38,11,13,14,48,58,-10,46
Scottish Premiership 2016/17,Kilmarnock,38,9,14,15,36,56,-20,41
Scottish Premiership 2016/17,Motherwell,38,10,8,20,46,69,-23,38
Scottish Premiership 2016/17,Dundee,38,10,7,21,38,62,-24,37
Scottish Premiership 2016/17,Hamilton Academical,38,7,14,17,37,56,-19,35
Scottish Premiership 2016/17,Inverness CT,38,7,13,18,44,71,-27,34
Scottish Premiership 2017/18,Celtic,38,24,10,4,73,25,48,82
Scottish Premiership 2017/18,Aberdeen,38,22,7,9,56,37,19,73
Scottish Premiership 2017/18,Rangers,38,21,7,10,76,50,26,70
Scottish Premiership 2017/18,Hibernian,38,18,13,7,62,46,16,67
Scottish Premiership 2017/18,Kilmarnock,38,16,11,11,49,47,2,59
Scottish Premiership 2017/18,Hearts,38,12,13,13,39,39,0,49
Scottish Premiership 2017/18,Motherwell,38,13,9,16,43,49,-6,48
Scottish Premiership 2017/18,St. Johnstone,38,12,10,16,42,53,-11,46
Scottish Premiership 2017/18,Dundee,38,11,6,21,36,57,-21,39
Scottish Premiership 2017/18,Hamilton Academical,38,9,6,23,47,68,-21,33
Scottish Premiership 2017/18,Partick Thistle,38,8,9,21,31,61,-30,33
Scottish Premiership 2017/18,Ross County,38,6,11,21,40,62,-22,29
Scottish Premiership 2018/19,Celtic,38,27,6,5,77,20,57,87
Scottish Premiership 2018/19,Rangers,38,23,9,6,82,27,55,78
Scottish Premiership 2018/19,Kilmarnock,38,19,10,9,50,31,19,67
Scottish Premiership 2018/19,Aberdeen,38,20,7,11,57,44,13,67
Scottish Premiership 2018/19,Hibernian,38,14,12,12,51,39,12,54
Scottish Premiership 2018/19,Hearts,38,15,6,17,42,50,-8,51
Scottish Premiership 2018/19,St. Johnstone,38,15,7,16,38,48,-10,52
Scottish Premiership 2018/19,Motherwell,38,15,6,17,46,56,-10,51
Scottish Premiership 2018/19,Livingston,38,11,11,16,42,44,-2,44
Scottish Premiership 2018/19,Hamilton Academical,38,9,6,23,28,75,-47,33
Scottish Premiership 2018/19,St Mirren,38,8,8,22,34,66,-32,32
Scottish Premiership 2018/19,Dundee,38,5,6,27,31,78,-47,21
Scottish Premiership 2019/20,Celtic,30,26,2,2,89,19,70,80
Scottish Premiership 2019/20,Rangers,29,21,4,4,64,19,45,67
Scottish Premiership 2019/20,Motherwell,30,14,4,12,41,38,3,46
Scottish Premiership 2019/20,Aberdeen,30,12,9,9,40,36,4,45
Scottish Premiership 2019/20,Livingston,30,10,9,11,41,39,2,39
Scottish Premiership 2019/20,St. Johnstone,29,8,12,9,28,46,-18,36
Scottish Premiership 2019/20,Hibernian,30,9,10,11,42,49,-7,37
Scottish Premiership 2019/20,Kilmarnock,30,9,6,15,31,41,-10,33
Scottish Premiership 2019/20,St Mirren,30,7,8,15,24,41,-17,29
Scottish Premiership 2019/20,Ross County,30,7,8,15,29,60,-31,29
Scottish Premiership 2019/20,Hamilton Academical,30,6,9,15,30,50,-20,27
Scottish Premiership 2019/20,Hearts,30,4,11,15,31,52,-21,23
Scottish Premiership 2020/21,Rangers,13,11,2,0,29,3,26,35
Scottish Premiership 2020/21,Celtic,11,8,2,1,28,10,18,26
Scottish Premiership 2020/21,Hibernian,12,7,3,2,17,10,7,24
Scottish Premiership 2020/21,Aberdeen,11,7,2,2,17,11,6,23
Scottish Premiership 2020/21,Dundee United,13,4,4,5,10,17,-7,16
Scottish Premiership 2020/21,Kilmarnock,12,4,2,6,15,14,1,14
Scottish Premiership 2020/21,Motherwell,11,4,2,5,13,13,0,14
Scottish Premiership 2020/21,Ross County,13,3,3,7,8,22,-14,12
Scottish Premiership 2020/21,St. Johnstone,12,3,2,7,9,16,-7,11
Scottish Premiership 2020/21,Livingston,13,3,2,8,13,22,-9,11
Scottish Premiership 2020/21,St Mirren,10,2,1,7,6,15,-9,7
Scottish Premiership 2020/21,Hamilton Academical,11,2,1,8,13,25,-12,7
Italy Serie A 2009/10,Inter Milan,38,24,10,4,75,34,41,82
Italy Serie A 2009/10,Roma,38,24,8,6,68,41,27,80
Italy Serie A 2009/10,AC Milan,38,20,10,8,60,39,21,70
Italy Serie A 2009/10,Sampdoria,38,19,10,9,49,41,8,67
Italy Serie A 2009/10,Palermo,38,18,11,9,59,47,12,65
Italy Serie A 2009/10,Napoli,38,15,14,9,50,43,7,59
Italy Serie A 2009/10,Juventus,38,16,7,15,55,56,-1,55
Italy Serie A 2009/10,Parma,38,14,10,14,46,51,-5,52
Italy Serie A 2009/10,Genoa,38,14,9,15,57,61,-4,51
Italy Serie A 2009/10,Bari,38,13,11,14,49,49,0,50
Italy Serie A 2009/10,Fiorentina,38,13,8,17,48,47,1,47
Italy Serie A 2009/10,Lazio,38,11,13,14,39,43,-4,46
Italy Serie A 2009/10,Catania,38,10,15,13,44,45,-1,45
Italy Serie A 2009/10,Chievo,38,12,8,18,37,42,-5,44
Italy Serie A 2009/10,Udinese,38,11,11,16,54,59,-5,44
Italy Serie A 2009/10,Cagliari,38,11,11,16,56,58,-2,44
Italy Serie A 2009/10,Bologna,38,10,12,16,42,55,-13,42
Italy Serie A 2009/10,Atalanta,38,9,8,21,37,53,-16,35
Italy Serie A 2009/10,Siena,38,7,10,21,40,67,-27,31
Italy Serie A 2009/10,Livorno,38,7,8,23,27,61,-34,29
Italy Serie A 2010/11,AC Milan,38,24,10,4,65,24,41,82
Italy Serie A 2010/11,Inter Milan,38,23,7,8,69,42,27,76
Italy Serie A 2010/11,Napoli,38,21,7,10,59,39,20,70
Italy Serie A 2010/11,Udinese,38,20,6,12,65,43,22,66
Italy Serie A 2010/11,Lazio,38,20,6,12,55,39,16,66
Italy Serie A 2010/11,Roma,38,18,9,11,59,52,7,63
Italy Serie A 2010/11,Juventus,38,15,13,10,57,47,10,58
Italy Serie A 2010/11,Palermo,38,17,5,16,58,63,-5,56
Italy Serie A 2010/11,Fiorentina,38,12,15,11,49,44,5,51
Italy Serie A 2010/11,Genoa,38,14,9,15,45,47,-2,51
Italy Serie A 2010/11,Chievo,38,11,13,14,38,40,-2,46
Italy Serie A 2010/11,Parma,38,11,13,14,39,47,-8,46
Italy Serie A 2010/11,Catania,38,12,10,16,40,52,-12,46
Italy Serie A 2010/11,Cagliari,38,12,9,17,44,51,-7,45
Italy Serie A 2010/11,Cesena,38,11,10,17,38,50,-12,43
Italy Serie A 2010/11,Bologna *,38,11,12,15,35,52,-17,42
Italy Serie A 2010/11,Lecce,38,11,8,19,46,66,-20,41
Italy Serie A 2010/11,Sampdoria,38,8,12,18,33,49,-16,36
Italy Serie A 2010/11,Brescia,38,7,11,20,34,52,-18,32
Italy Serie A 2010/11,Bari,38,5,9,24,27,56,-29,24
Italy Serie A 2011/12,Juventus,38,23,15,0,68,20,48,84
Italy Serie A 2011/12,AC Milan,38,24,8,6,74,33,41,80
Italy Serie A 2011/12,Udinese,38,18,10,10,52,35,17,64
Italy Serie A 2011/12,Lazio,38,18,8,12,56,47,9,62
Italy Serie A 2011/12,Napoli,38,16,13,9,66,46,20,61
Italy Serie A 2011/12,Inter Milan,38,17,7,14,58,55,3,58
Italy Serie A 2011/12,Roma,38,16,8,14,60,54,6,56
Italy Serie A 2011/12,Parma,38,15,11,12,54,53,1,56
Italy Serie A 2011/12,Bologna,38,13,12,13,41,43,-2,51
Italy Serie A 2011/12,Chievo,38,12,13,13,35,45,-10,49
Italy Serie A 2011/12,Catania,38,11,15,12,47,52,-5,48
Italy Serie A 2011/12,Atalanta *,38,13,13,12,41,43,-2,46
Italy Serie A 2011/12,Fiorentina,38,11,13,14,37,43,-6,46
Italy Serie A 2011/12,Siena,38,11,11,16,45,45,0,44
Italy Serie A 2011/12,Cagliari,38,10,13,15,37,46,-9,43
Italy Serie A 2011/12,Palermo,38,11,10,17,52,62,-10,43
Italy Serie A 2011/12,Genoa,38,11,9,18,50,69,-19,42
Italy Serie A 2011/12,Lecce,38,8,12,18,40,56,-16,36
Italy Serie A 2011/12,Novara,38,7,11,20,35,65,-30,32
Italy Serie A 2011/12,Cesena,38,4,10,24,24,60,-36,22
Italy Serie A 2012/13,Juventus,38,27,6,5,71,24,47,87
Italy Serie A 2012/13,Napoli,38,23,9,6,73,36,37,78
Italy Serie A 2012/13,AC Milan,38,21,9,8,67,39,28,72
Italy Serie A 2012/13,Fiorentina,38,21,7,10,72,44,28,70
Italy Serie A 2012/13,Udinese,38,18,12,8,59,45,14,66
Italy Serie A 2012/13,Roma,38,18,8,12,71,56,15,62
Italy Serie A 2012/13,Lazio,38,18,7,13,51,42,9,61
Italy Serie A 2012/13,Catania,38,15,11,12,50,46,4,56
Italy Serie A 2012/13,Inter Milan,38,16,6,16,55,57,-2,54
Italy Serie A 2012/13,Parma,38,13,10,15,45,46,-1,49
Italy Serie A 2012/13,Cagliari,38,12,11,15,43,55,-12,47
Italy Serie A 2012/13,Chievo,38,12,9,17,37,52,-15,45
Italy Serie A 2012/13,Bologna,38,11,11,16,46,52,-6,44
Italy Serie A 2012/13,Sampdoria *,38,11,10,17,43,51,-8,42
Italy Serie A 2012/13,Atalanta *,38,11,9,18,39,56,-17,40
Italy Serie A 2012/13,Torino *,38,8,16,14,46,55,-9,39
Italy Serie A 2012/13,Genoa,38,8,14,16,38,52,-14,38
Italy Serie A 2012/13,Palermo,38,6,14,18,34,54,-20,32
Italy Serie A 2012/13,Siena *,38,9,9,20,36,57,-21,30
Italy Serie A 2012/13,Pescara,38,6,4,28,27,84,-57,22
Italy Serie A 2013/14,Juventus,38,33,3,2,80,23,57,102
Italy Serie A 2013/14,Roma,38,26,7,5,72,25,47,85
Italy Serie A 2013/14,Napoli,38,23,9,6,77,39,38,78
Italy Serie A 2013/14,Fiorentina,38,19,8,11,65,44,21,65
Italy Serie A 2013/14,Inter Milan,38,15,15,8,62,39,23,60
Italy Serie A 2013/14,Parma,38,15,13,10,58,46,12,58
Italy Serie A 2013/14,Torino,38,15,12,11,58,48,10,57
Italy Serie A 2013/14,AC Milan,38,16,9,13,57,49,8,57
Italy Serie A 2013/14,Lazio,38,15,11,12,54,54,0,56
Italy Serie A 2013/14,Verona,38,16,6,16,62,68,-6,54
Italy Serie A 2013/14,Atalanta,38,15,5,18,43,51,-8,50
Italy Serie A 2013/14,Sampdoria,38,12,9,17,48,62,-14,45
Italy Serie A 2013/14,Udinese,38,12,8,18,46,57,-11,44
Italy Serie A 2013/14,Genoa,38,11,11,16,41,50,-9,44
Italy Serie A 2013/14,Cagliari,38,9,12,17,34,53,-19,39
Italy Serie A 2013/14,Chievo,38,10,6,22,34,54,-20,36
Italy Serie A 2013/14,Sassuolo,38,9,7,22,43,72,-29,34
Italy Serie A 2013/14,Catania,38,8,8,22,34,66,-32,32
Italy Serie A 2013/14,Bologna,38,5,14,19,28,58,-30,29
Italy Serie A 2013/14,Livorno,38,6,7,25,39,77,-38,25
Italian Serie A 2014/15,Juventus,38,26,9,3,72,24,48,87
Italian Serie A 2014/15,Roma,38,19,13,6,54,31,23,70
Italian Serie A 2014/15,Lazio,38,21,6,11,71,38,33,69
Italian Serie A 2014/15,Fiorentina,38,18,10,10,61,46,15,64
Italian Serie A 2014/15,Napoli,38,18,9,11,70,54,16,63
Italian Serie A 2014/15,Genoa,38,16,11,11,62,47,15,59
Italian Serie A 2014/15,Sampdoria,38,13,17,8,48,42,6,56
Italian Serie A 2014/15,Inter Milan,38,14,13,11,59,48,11,55
Italian Serie A 2014/15,Torino,38,14,12,12,48,45,3,54
Italian Serie A 2014/15,AC Milan,38,13,13,12,56,50,6,52
Italian Serie A 2014/15,Palermo,38,12,13,13,53,55,-2,49
Italian Serie A 2014/15,Sassuolo,38,12,13,13,49,57,-8,49
Italian Serie A 2014/15,Verona,38,11,13,14,49,65,-16,46
Italian Serie A 2014/15,Chievo,38,10,13,15,28,41,-13,43
Italian Serie A 2014/15,Empoli,38,8,18,12,46,52,-6,42
Italian Serie A 2014/15,Udinese,38,10,11,17,43,56,-13,41
Italian Serie A 2014/15,Atalanta,38,7,16,15,38,57,-19,37
Italian Serie A 2014/15,Cagliari,38,8,10,20,48,68,-20,34
Italian Serie A 2014/15,Cesena,38,4,12,22,36,73,-37,24
Italian Serie A 2014/15,Parma *,38,6,8,24,33,75,-42,19
Italian Serie A 2015/16,Juventus,38,29,4,5,75,20,55,91
Italian Serie A 2015/16,Napoli,38,25,7,6,80,32,48,82
Italian Serie A 2015/16,Roma,38,23,11,4,83,41,42,80
Italian Serie A 2015/16,Inter Milan,38,20,7,11,50,38,12,67
Italian Serie A 2015/16,Fiorentina,38,18,10,10,60,42,18,64
Italian Serie A 2015/16,Sassuolo,38,16,13,9,49,40,9,61
Italian Serie A 2015/16,AC Milan,38,15,12,11,49,43,6,57
Italian Serie A 2015/16,Lazio,38,15,9,14,52,52,0,54
Italian Serie A 2015/16,Chievo,38,13,11,14,43,45,-2,50
Italian Serie A 2015/16,Empoli,38,12,10,16,40,49,-9,46
Italian Serie A 2015/16,Genoa,38,13,7,18,45,48,-3,46
Italian Serie A 2015/16,Torino,38,12,9,17,52,55,-3,45
Italian Serie A 2015/16,Atalanta,38,11,12,15,41,47,-6,45
Italian Serie A 2015/16,Bologna,38,11,9,18,33,45,-12,42
Italian Serie A 2015/16,Sampdoria,38,10,10,18,48,61,-13,40
Italian Serie A 2015/16,Palermo,38,10,9,19,38,65,-27,39
Italian Serie A 2015/16,Udinese,38,10,9,19,35,60,-25,39
Italian Serie A 2015/16,Carpi,38,9,11,18,37,57,-20,38
Italian Serie A 2015/16,Frosinone,38,8,7,23,35,76,-41,31
Italian Serie A 2015/16,Verona,38,5,13,20,34,63,-29,28
Italian Serie A 2016/17,Juventus,38,29,4,5,77,27,50,91
Italian Serie A 2016/17,Roma,38,28,3,7,90,38,52,87
Italian Serie A 2016/17,Napoli,38,26,8,4,94,39,55,86
Italian Serie A 2016/17,Atalanta,38,21,9,8,62,41,21,72
Italian Serie A 2016/17,Lazio,38,21,7,10,74,51,23,70
Italian Serie A 2016/17,AC Milan,38,18,9,11,57,45,12,63
Italian Serie A 2016/17,Inter Milan,38,19,5,14,72,49,23,62
Italian Serie A 2016/17,Fiorentina,38,16,12,10,63,57,6,60
Italian Serie A 2016/17,Torino,38,13,14,11,71,66,5,53
Italian Serie A 2016/17,Sampdoria,38,12,12,14,49,55,-6,48
Italian Serie A 2016/17,Cagliari,38,14,5,19,55,76,-21,47
Italian Serie A 2016/17,Sassuolo,38,13,7,18,58,63,-5,46
Italian Serie A 2016/17,Udinese,38,12,9,17,47,56,-9,45
Italian Serie A 2016/17,Chievo,38,12,7,19,43,61,-18,43
Italian Serie A 2016/17,Bologna,38,11,8,19,40,58,-18,41
Italian Serie A 2016/17,Genoa,38,9,9,20,38,64,-26,36
Italian Serie A 2016/17,Crotone,38,9,7,22,34,58,-24,34
Italian Serie A 2016/17,Empoli,38,8,8,22,29,61,-32,32
Italian Serie A 2016/17,Palermo,38,6,8,24,33,77,-44,26
Italian Serie A 2016/17,Pescara,38,3,9,26,37,81,-44,18
Italian Serie A 2017/18,Juventus,38,30,5,3,86,24,62,95
Italian Serie A 2017/18,Napoli,38,28,7,3,77,29,48,91
Italian Serie A 2017/18,Roma,38,23,8,7,61,28,33,77
Italian Serie A 2017/18,Inter Milan,38,20,12,6,66,30,36,72
Italian Serie A 2017/18,Lazio,38,21,9,8,89,49,40,72
Italian Serie A 2017/18,AC Milan,38,18,10,10,56,42,14,64
Italian Serie A 2017/18,Atalanta,38,16,12,10,57,39,18,60
Italian Serie A 2017/18,Fiorentina,38,16,9,13,54,46,8,57
Italian Serie A 2017/18,Torino,38,13,15,10,54,46,8,54
Italian Serie A 2017/18,Sampdoria,38,16,6,16,56,60,-4,54
Italian Serie A 2017/18,Sassuolo,38,11,10,17,29,59,-30,43
Italian Serie A 2017/18,Genoa,38,11,8,19,33,43,-10,41
Italian Serie A 2017/18,Chievo,38,10,10,18,36,59,-23,40
Italian Serie A 2017/18,Udinese,38,12,4,22,48,63,-15,40
Italian Serie A 2017/18,Bologna,38,11,6,21,40,52,-12,39
Italian Serie A 2017/18,Cagliari,38,11,6,21,33,61,-28,39
Italian Serie A 2017/18,Spal,38,8,14,16,39,59,-20,38
Italian Serie A 2017/18,Crotone,38,9,8,21,40,66,-26,35
Italian Serie A 2017/18,Verona,38,7,4,27,30,78,-48,25
Italian Serie A 2017/18,Benevento,38,6,3,29,33,84,-51,21
Italian Serie A 2018/19,Juventus,38,28,6,4,70,30,40,90
Italian Serie A 2018/19,Napoli,38,24,7,7,74,36,38,79
Italian Serie A 2018/19,Atalanta,38,20,9,9,77,46,31,69
Italian Serie A 2018/19,Inter Milan,38,20,9,9,57,33,24,69
Italian Serie A 2018/19,AC Milan,38,19,11,8,55,36,19,68
Italian Serie A 2018/19,Roma,38,18,12,8,66,48,18,66
Italian Serie A 2018/19,Torino,38,16,15,7,52,37,15,63
Italian Serie A 2018/19,Lazio,38,17,8,13,56,46,10,59
Italian Serie A 2018/19,Sampdoria,38,15,8,15,60,51,9,53
Italian Serie A 2018/19,Bologna,38,11,11,16,48,56,-8,44
Italian Serie A 2018/19,Sassuolo,38,9,16,13,53,60,-7,43
Italian Serie A 2018/19,Udinese,38,11,10,17,39,53,-14,43
Italian Serie A 2018/19,Spal,38,11,9,18,44,56,-12,42
Italian Serie A 2018/19,Parma,38,10,11,17,41,61,-20,41
Italian Serie A 2018/19,Cagliari,38,10,11,17,36,54,-18,41
Italian Serie A 2018/19,Fiorentina,38,8,17,13,47,45,2,41
Italian Serie A 2018/19,Genoa,38,8,14,16,39,57,-18,38
Italian Serie A 2018/19,Empoli,38,10,8,20,51,70,-19,38
Italian Serie A 2018/19,Frosinone,38,5,10,23,29,69,-40,25
Italian Serie A 2018/19,Chievo,38,2,14,22,25,75,-50,17
Italian Serie A 2019/20,Juventus,38,26,5,7,76,43,33,83
Italian Serie A 2019/20,Inter Milan,38,24,10,4,81,36,45,82
Italian Serie A 2019/20,Atalanta,38,23,9,6,98,48,50,78
Italian Serie A 2019/20,Lazio,38,24,6,8,79,42,37,78
Italian Serie A 2019/20,Roma,38,21,7,10,77,51,26,70
Italian Serie A 2019/20,AC Milan,38,19,9,10,63,46,17,66
Italian Serie A 2019/20,Napoli,38,18,8,12,61,50,11,62
Italian Serie A 2019/20,Sassuolo,38,14,9,15,69,63,6,51
Italian Serie A 2019/20,Verona,38,12,13,13,47,51,-4,49
Italian Serie A 2019/20,Fiorentina,38,12,13,13,51,48,3,49
Italian Serie A 2019/20,Parma,38,14,7,17,56,57,-1,49
Italian Serie A 2019/20,Bologna,38,12,11,15,52,65,-13,47
Italian Serie A 2019/20,Udinese,38,12,9,17,37,51,-14,45
Italian Serie A 2019/20,Cagliari,38,11,12,15,52,56,-4,45
Italian Serie A 2019/20,Sampdoria,38,12,6,20,48,65,-17,42
Italian Serie A 2019/20,Torino,38,11,7,20,46,68,-22,40
Italian Serie A 2019/20,Genoa,38,10,9,19,47,73,-26,39
Italian Serie A 2019/20,Lecce,38,9,8,21,52,85,-33,35
Italian Serie A 2019/20,Brescia,38,6,7,25,35,79,-44,25
Italian Serie A 2019/20,Spal,38,5,5,28,27,77,-50,20
Italian Serie A 2020/21,AC Milan,6,5,1,0,14,5,9,16
Italian Serie A 2020/21,Sassuolo,6,4,2,0,18,9,9,14
Italian Serie A 2020/21,Juventus,6,3,3,0,14,5,9,12
Italian Serie A 2020/21,Atalanta,6,4,0,2,17,13,4,12
Italian Serie A 2020/21,Napoli *,6,4,0,2,14,7,7,11
Italian Serie A 2020/21,Inter Milan,6,3,2,1,15,10,5,11
Italian Serie A 2020/21,Verona,6,3,2,1,8,3,5,11
Italian Serie A 2020/21,Roma,6,3,2,1,13,10,3,11
Italian Serie A 2020/21,Sampdoria,6,3,1,2,11,9,2,10
Italian Serie A 2020/21,Lazio,6,3,1,2,10,12,-2,10
Italian Serie A 2020/21,Fiorentina,6,2,1,3,10,12,-2,7
Italian Serie A 2020/21,Cagliari,6,2,1,3,12,15,-3,7
Italian Serie A 2020/21,Bologna,6,2,0,4,11,12,-1,6
Italian Serie A 2020/21,Benevento,6,2,0,4,10,17,-7,6
Italian Serie A 2020/21,Genoa,5,1,2,2,5,10,-5,5
Italian Serie A 2020/21,Parma,6,1,2,3,8,13,-5,5
Italian Serie A 2020/21,Spezia,6,1,2,3,8,15,-7,5
Italian Serie A 2020/21,Udinese,6,1,0,5,6,11,-5,3
Italian Serie A 2020/21,Torino,5,0,1,4,10,15,-5,1
Italian Serie A 2020/21,Crotone,6,0,1,5,6,17,-11,1
SheBelieves Cup 2018/19,England Women,3,2,1,0,7,3,4,7
SheBelieves Cup 2018/19,USA Women,3,1,2,0,5,4,1,5
SheBelieves Cup 2018/19,Japan Women,3,1,1,1,5,6,-1,4
SheBelieves Cup 2018/19,Brazil Women,3,0,0,3,2,6,-4,0
SheBelieves Cup 2019/20,USA Women,3,3,0,0,6,1,5,9
SheBelieves Cup 2019/20,Spain Women,3,2,0,1,4,2,2,6
SheBelieves Cup 2019/20,England Women,3,1,0,2,1,3,-2,3
SheBelieves Cup 2019/20,Japan Women,3,0,0,3,2,7,-5,0
UEFA Nations League - Group C2 2018/19,Finland,6,4,0,2,5,3,2,12
UEFA Nations League - Group C2 2018/19,Hungary,6,3,1,2,9,6,3,10
UEFA Nations League - Group C2 2018/19,Greece,6,3,0,3,4,5,-1,9
UEFA Nations League - Group C2 2018/19,Estonia,6,1,1,4,4,8,-4,4
UEFA Nations League - Group C3 2018/19,Norway,6,4,1,1,7,2,5,13
UEFA Nations League - Group C3 2018/19,Bulgaria,6,3,2,1,7,5,2,11
UEFA Nations League - Group C3 2018/19,Cyprus,6,1,2,3,5,9,-4,5
UEFA Nations League - Group C3 2018/19,Slovenia,6,0,3,3,5,8,-3,3
UEFA Nations League - Group C4 2018/19,Serbia,6,4,2,0,11,4,7,14
UEFA Nations League - Group C4 2018/19,Romania,6,3,3,0,8,3,5,12
UEFA Nations League - Group C4 2018/19,Montenegro,6,2,1,3,7,6,1,7
UEFA Nations League - Group C4 2018/19,Lithuania,6,0,0,6,3,16,-13,0
UEFA Nations League - Group D1 2018/19,Georgia,6,5,1,0,12,2,10,16
UEFA Nations League - Group D1 2018/19,Kazakhstan,6,1,3,2,8,7,1,6
UEFA Nations League - Group D1 2018/19,Latvia,6,0,4,2,2,6,-4,4
UEFA Nations League - Group D1 2018/19,Andorra,6,0,4,2,2,9,-7,4
UEFA Nations League - Group D2 2018/19,Belarus,6,4,2,0,10,0,10,14
UEFA Nations League - Group D2 2018/19,Luxembourg,6,3,1,2,11,4,7,10
UEFA Nations League - Group D2 2018/19,Moldova,6,2,3,1,4,5,-1,9
UEFA Nations League - Group D2 2018/19,San Marino,6,0,0,6,0,16,-16,0
UEFA Nations League - Group D3 2018/19,Kosovo,6,4,2,0,15,2,13,14
UEFA Nations League - Group D3 2018/19,Azerbaijan,6,2,3,1,7,6,1,9
UEFA Nations League - Group D3 2018/19,Faroe Islands,6,1,2,3,5,10,-5,5
UEFA Nations League - Group D3 2018/19,Malta,6,0,3,3,5,14,-9,3
UEFA Nations League - Group D4 2018/19,North Macedonia,6,5,0,1,14,5,9,15
UEFA Nations League - Group D4 2018/19,Armenia,6,3,1,2,14,8,6,10
UEFA Nations League - Group D4 2018/19,Gibraltar,6,2,0,4,5,15,-10,6
UEFA Nations League - Group D4 2018/19,Liechtenstein,6,1,1,4,7,12,-5,4
UEFA Nations League - Group A1 2019/20,Bosnia and Herzegovina,0,0,0,0,0,0,0,0
UEFA Nations League - Group A1 2019/20,Italy,0,0,0,0,0,0,0,0
UEFA Nations League - Group A1 2019/20,Netherlands,0,0,0,0,0,0,0,0
UEFA Nations League - Group A1 2019/20,Poland,0,0,0,0,0,0,0,0
UEFA Nations League - Group A2 2019/20,Belgium,0,0,0,0,0,0,0,0
UEFA Nations League - Group A2 2019/20,Denmark,0,0,0,0,0,0,0,0
UEFA Nations League - Group A2 2019/20,England,0,0,0,0,0,0,0,0
UEFA Nations League - Group A2 2019/20,Iceland,0,0,0,0,0,0,0,0
UEFA Nations League - Group A3 2019/20,Croatia,0,0,0,0,0,0,0,0
UEFA Nations League - Group A3 2019/20,France,0,0,0,0,0,0,0,0
UEFA Nations League - Group A3 2019/20,Portugal,0,0,0,0,0,0,0,0
UEFA Nations League - Group A3 2019/20,Sweden,0,0,0,0,0,0,0,0
UEFA Nations League - Group A4 2019/20,Germany,0,0,0,0,0,0,0,0
UEFA Nations League - Group A4 2019/20,Spain,0,0,0,0,0,0,0,0
UEFA Nations League - Group A4 2019/20,Switzerland,0,0,0,0,0,0,0,0
UEFA Nations League - Group A4 2019/20,Ukraine,0,0,0,0,0,0,0,0
UEFA Nations League - Group B1 2019/20,Austria,0,0,0,0,0,0,0,0
UEFA Nations League - Group B1 2019/20,Northern Ireland,0,0,0,0,0,0,0,0
UEFA Nations League - Group B1 2019/20,Norway,0,0,0,0,0,0,0,0
UEFA Nations League - Group B1 2019/20,Romania,0,0,0,0,0,0,0,0
UEFA Nations League - Group B2 2019/20,Czech Republic,0,0,0,0,0,0,0,0
UEFA Nations League - Group B2 2019/20,Israel,0,0,0,0,0,0,0,0
UEFA Nations League - Group B2 2019/20,Scotland,0,0,0,0,0,0,0,0
UEFA Nations League - Group B2 2019/20,Slovakia,0,0,0,0,0,0,0,0
UEFA Nations League - Group B3 2019/20,Hungary,0,0,0,0,0,0,0,0
UEFA Nations League - Group B3 2019/20,Russia,0,0,0,0,0,0,0,0
UEFA Nations League - Group B3 2019/20,Serbia,0,0,0,0,0,0,0,0
UEFA Nations League - Group B3 2019/20,Turkey,0,0,0,0,0,0,0,0
UEFA Nations League - Group B4 2019/20,Bulgaria,0,0,0,0,0,0,0,0
UEFA Nations League - Group B4 2019/20,Finland,0,0,0,0,0,0,0,0
UEFA Nations League - Group B4 2019/20,Republic of Ireland,0,0,0,0,0,0,0,0
UEFA Nations League - Group B4 2019/20,Wales,0,0,0,0,0,0,0,0
UEFA Nations League - Group C1 2019/20,Azerbaijan,0,0,0,0,0,0,0,0
UEFA Nations League - Group C1 2019/20,Cyprus,0,0,0,0,0,0,0,0
UEFA Nations League - Group C1 2019/20,Luxembourg,0,0,0,0,0,0,0,0
UEFA Nations League - Group C1 2019/20,Montenegro,0,0,0,0,0,0,0,0
UEFA Nations League - Group C2 2019/20,Armenia,0,0,0,0,0,0,0,0
UEFA Nations League - Group C2 2019/20,Estonia,0,0,0,0,0,0,0,0
UEFA Nations League - Group C2 2019/20,Georgia,0,0,0,0,0,0,0,0
UEFA Nations League - Group C2 2019/20,North Macedonia,0,0,0,0,0,0,0,0
UEFA Nations League - Group C3 2019/20,Greece,0,0,0,0,0,0,0,0
UEFA Nations League - Group C3 2019/20,Kosovo,0,0,0,0,0,0,0,0
UEFA Nations League - Group C3 2019/20,Moldova,0,0,0,0,0,0,0,0
UEFA Nations League - Group C3 2019/20,Slovenia,0,0,0,0,0,0,0,0
UEFA Nations League - Group C4 2019/20,Albania,0,0,0,0,0,0,0,0
UEFA Nations League - Group C4 2019/20,Belarus,0,0,0,0,0,0,0,0
UEFA Nations League - Group C4 2019/20,Kazakhstan,0,0,0,0,0,0,0,0
UEFA Nations League - Group C4 2019/20,Lithuania,0,0,0,0,0,0,0,0
UEFA Nations League - Group D1 2019/20,Andorra,0,0,0,0,0,0,0,0
UEFA Nations League - Group D1 2019/20,Faroe Islands,0,0,0,0,0,0,0,0
UEFA Nations League - Group D1 2019/20,Latvia,0,0,0,0,0,0,0,0
UEFA Nations League - Group D1 2019/20,Malta,0,0,0,0,0,0,0,0
UEFA Nations League - Group D2 2019/20,Gibraltar,0,0,0,0,0,0,0,0
UEFA Nations League - Group D2 2019/20,Liechtenstein,0,0,0,0,0,0,0,0
UEFA Nations League - Group D2 2019/20,San Marino,0,0,0,0,0,0,0,0
UEFA Nations League - Group A1 2020/21,Poland,4,2,1,1,5,2,3,7
UEFA Nations League - Group A1 2020/21,Italy,4,1,3,0,3,2,1,6
UEFA Nations League - Group A1 2020/21,Netherlands,4,1,2,1,2,2,0,5
UEFA Nations League - Group A1 2020/21,Bosnia and Herzegovina,4,0,2,2,2,6,-4,2
UEFA Nations League - Group A2 2020/21,Belgium,4,3,0,1,10,4,6,9
UEFA Nations League - Group A2 2020/21,Denmark,4,2,1,1,4,2,2,7
UEFA Nations League - Group A2 2020/21,England,4,2,1,1,3,2,1,7
UEFA Nations League - Group A2 2020/21,Iceland,4,0,0,4,2,11,-9,0
UEFA Nations League - Group A3 2020/21,Portugal,4,3,1,0,9,1,8,10
UEFA Nations League - Group A3 2020/21,France,4,3,1,0,7,3,4,10
UEFA Nations League - Group A3 2020/21,Croatia,4,1,0,3,6,11,-5,3
UEFA Nations League - Group A3 2020/21,Sweden,4,0,0,4,1,8,-7,0
UEFA Nations League - Group A4 2020/21,Spain,4,2,1,1,6,2,4,7
UEFA Nations League - Group A4 2020/21,Germany,4,1,3,0,7,6,1,6
UEFA Nations League - Group A4 2020/21,Ukraine,4,2,0,2,4,7,-3,6
UEFA Nations League - Group A4 2020/21,Switzerland,4,0,2,2,5,7,-2,2
UEFA Nations League - Group B1 2020/21,Austria,4,3,0,1,6,4,2,9
UEFA Nations League - Group B1 2020/21,Norway,4,3,0,1,11,3,8,9
UEFA Nations League - Group B1 2020/21,Romania,4,1,1,2,4,8,-4,4
UEFA Nations League - Group B1 2020/21,Northern Ireland,4,0,1,3,2,8,-6,1
UEFA Nations League - Group B2 2020/21,Scotland,4,3,1,0,5,2,3,10
UEFA Nations League - Group B2 2020/21,Czech Republic,4,2,0,2,6,5,1,6
UEFA Nations League - Group B2 2020/21,Israel,4,1,2,1,6,6,0,5
UEFA Nations League - Group B2 2020/21,Slovakia,4,0,1,3,4,8,-4,1
UEFA Nations League - Group B3 2020/21,Russia,4,2,2,0,7,4,3,8
UEFA Nations League - Group B3 2020/21,Hungary,4,2,1,1,4,3,1,7
UEFA Nations League - Group B3 2020/21,Turkey,4,0,3,1,3,4,-1,3
UEFA Nations League - Group B3 2020/21,Serbia,4,0,2,2,3,6,-3,2
UEFA Nations League - Group B4 2020/21,Wales,4,3,1,0,3,0,3,10
UEFA Nations League - Group B4 2020/21,Finland,4,3,0,1,4,1,3,9
UEFA Nations League - Group B4 2020/21,Republic of Ireland,4,0,2,2,1,3,-2,2
UEFA Nations League - Group B4 2020/21,Bulgaria,4,0,1,3,1,5,-4,1
UEFA Nations League - Group C1 2020/21,Luxembourg,4,3,0,1,6,3,3,9
UEFA Nations League - Group C1 2020/21,Montenegro,4,3,0,1,6,2,4,9
UEFA Nations League - Group C1 2020/21,Azerbaijan,4,1,1,2,2,4,-2,4
UEFA Nations League - Group C1 2020/21,Cyprus,4,0,1,3,0,5,-5,1
UEFA Nations League - Group C2 2020/21,North Macedonia,4,1,3,0,7,6,1,6
UEFA Nations League - Group C2 2020/21,Georgia,4,1,3,0,5,4,1,6
UEFA Nations League - Group C2 2020/21,Armenia,4,1,2,1,6,5,1,5
UEFA Nations League - Group C2 2020/21,Estonia,4,0,2,2,4,7,-3,2
UEFA Nations League - Group C3 2020/21,Slovenia,4,3,1,0,6,0,6,10
UEFA Nations League - Group C3 2020/21,Greece,4,2,2,0,4,1,3,8
UEFA Nations League - Group C3 2020/21,Kosovo,4,0,2,2,2,4,-2,2
UEFA Nations League - Group C3 2020/21,Moldova,4,0,1,3,1,8,-7,1
UEFA Nations League - Group C4 2020/21,Belarus,4,2,1,1,6,5,1,7
UEFA Nations League - Group C4 2020/21,Lithuania,4,1,2,1,3,4,-1,5
UEFA Nations League - Group C4 2020/21,Albania,4,1,2,1,2,1,1,5
UEFA Nations League - Group C4 2020/21,Kazakhstan,4,1,1,2,3,4,-1,4
UEFA Nations League - Group D1 2020/21,Faroe Islands,4,3,1,0,7,3,4,10
UEFA Nations League - Group D1 2020/21,Malta,4,1,2,1,4,4,0,5
UEFA Nations League - Group D1 2020/21,Latvia,4,0,3,1,2,3,-1,3
UEFA Nations League - Group D1 2020/21,Andorra,4,0,2,2,0,3,-3,2
UEFA Nations League - Group D2 2020/21,Gibraltar,2,2,0,0,2,0,2,6
UEFA Nations League - Group D2 2020/21,Liechtenstein,3,1,1,1,2,1,1,4
UEFA Nations League - Group D2 2020/21,San Marino,3,0,1,2,0,3,-3,1
European U-21 Champ - Group A 2008/09,Italy U21,3,2,1,0,4,2,2,7
European U-21 Champ - Group A 2008/09,Sweden U21,3,2,0,1,9,4,5,6
European U-21 Champ - Group A 2008/09,Serbia U21,3,0,2,1,1,3,-2,2
European U-21 Champ - Group A 2008/09,Belarus U21,3,0,1,2,2,7,-5,1
European U-21 Champ - Group B 2008/09,England U21,3,2,1,0,5,2,3,7
European U-21 Champ - Group B 2008/09,Germany U21,3,1,2,0,3,1,2,5
European U-21 Champ - Group B 2008/09,Spain U21,3,1,1,1,2,2,0,4
European U-21 Champ - Group B 2008/09,Finland U21,3,0,0,3,1,6,-5,0
European Under-21 Championship - Group A 2010/11,Belarus U21,1,1,0,0,2,0,2,3
European Under-21 Championship - Group A 2010/11,Switzerland U21,1,1,0,0,1,0,1,3
European Under-21 Championship - Group A 2010/11,Denmark U21,1,0,0,1,0,1,-1,0
European Under-21 Championship - Group A 2010/11,Iceland U21,1,0,0,1,0,2,-2,0
European Under-21 Championship - Group B 2010/11,Czech Rep U21,1,1,0,0,2,1,1,3
European Under-21 Championship - Group B 2010/11,England U21,1,0,1,0,1,1,0,1
European Under-21 Championship - Group B 2010/11,Spain U21,1,0,1,0,1,1,0,1
European Under-21 Championship - Group B 2010/11,Ukraine U21,1,0,0,1,1,2,-1,0
European Under-21 Championship - Group A 2011/12,Switzerland U21,3,3,0,0,6,0,6,9
European Under-21 Championship - Group A 2011/12,Belarus U21,3,1,0,2,3,5,-2,3
European Under-21 Championship - Group A 2011/12,Iceland U21,3,1,0,2,3,5,-2,3
European Under-21 Championship - Group A 2011/12,Denmark U21,3,1,0,2,3,5,-2,3
European Under-21 Championship - Group B 2011/12,Spain U21,3,2,1,0,6,1,5,7
European Under-21 Championship - Group B 2011/12,Czech Rep U21,3,2,0,1,4,4,0,6
European Under-21 Championship - Group B 2011/12,England U21,3,0,2,1,2,3,-1,2
European Under-21 Championship - Group B 2011/12,Ukraine U21,3,0,1,2,1,5,-4,1
European Under-21 Championship - Group A 2013/14,Italy U21,3,2,1,0,6,1,5,7
European Under-21 Championship - Group A 2013/14,Norway U21,3,1,2,0,6,4,2,5
European Under-21 Championship - Group A 2013/14,Israel U21,3,1,1,1,3,6,-3,4
European Under-21 Championship - Group A 2013/14,England U21,3,0,0,3,1,5,-4,0
European Under-21 Championship - Group B 2013/14,Spain U21,3,3,0,0,5,0,5,9
European Under-21 Championship - Group B 2013/14,Holland U21,3,2,0,1,8,6,2,6
European Under-21 Championship - Group B 2013/14,Germany U21,3,1,0,2,4,5,-1,3
European Under-21 Championship - Group B 2013/14,Russia U21,3,0,0,3,2,8,-6,0
European Under-21 Championship - Group A 2014/15,Germany U21,0,0,0,0,0,0,0,0
European Under-21 Championship - Group A 2014/15,Denmark U21,0,0,0,0,0,0,0,0
European Under-21 Championship - Group A 2014/15,Czech Rep U21,0,0,0,0,0,0,0,0
European Under-21 Championship - Group A 2014/15,Serbia U21,0,0,0,0,0,0,0,0
European Under-21 Championship - Group B 2014/15,Italy U21,0,0,0,0,0,0,0,0
European Under-21 Championship - Group B 2014/15,England U21,0,0,0,0,0,0,0,0
European Under-21 Championship - Group B 2014/15,Sweden U21,0,0,0,0,0,0,0,0
European Under-21 Championship - Group B 2014/15,Portugal U21,0,0,0,0,0,0,0,0
European Under-21 Championship - Group A 2015/16,Denmark U21,3,2,0,1,4,4,0,6
European Under-21 Championship - Group A 2015/16,Germany U21,3,1,2,0,5,2,3,5
European Under-21 Championship - Group A 2015/16,Czech Rep U21,3,1,1,1,6,3,3,4
European Under-21 Championship - Group A 2015/16,Serbia U21,3,0,1,2,1,7,-6,1
European Under-21 Championship - Group B 2015/16,Portugal U21,3,1,2,0,2,1,1,5
European Under-21 Championship - Group B 2015/16,Sweden U21,3,1,1,1,3,3,0,4
European Under-21 Championship - Group B 2015/16,Italy U21,3,1,1,1,4,3,1,4
European Under-21 Championship - Group B 2015/16,England U21,3,1,0,2,2,4,-2,3
European Under-21 Championship - Group A 2017/18,England U21,3,2,1,0,5,1,4,7
European Under-21 Championship - Group A 2017/18,Slovakia U21,3,2,0,1,6,3,3,6
European Under-21 Championship - Group A 2017/18,Sweden U21,3,0,2,1,2,5,-3,2
European Under-21 Championship - Group A 2017/18,Poland U21,3,0,1,2,3,7,-4,1
European Under-21 Championship - Group B 2017/18,Spain U21,3,3,0,0,9,1,8,9
European Under-21 Championship - Group B 2017/18,Portugal U21,3,2,0,1,7,5,2,6
European Under-21 Championship - Group B 2017/18,Serbia U21,3,0,1,2,2,5,-3,1
European Under-21 Championship - Group B 2017/18,Macedonia U21,3,0,1,2,4,11,-7,1
European Under-21 Championship - Group C 2017/18,Italy U21,3,2,0,1,4,3,1,6
European Under-21 Championship - Group C 2017/18,Germany U21,3,2,0,1,5,1,4,6
European Under-21 Championship - Group C 2017/18,Denmark U21,3,1,0,2,4,7,-3,3
European Under-21 Championship - Group C 2017/18,Czech Rep U21,3,1,0,2,5,7,-2,3
European Under-21 Championship - Group A 2018/19,Belgium U21,0,0,0,0,0,0,0,0
European Under-21 Championship - Group A 2018/19,Italy U21,0,0,0,0,0,0,0,0
European Under-21 Championship - Group A 2018/19,Poland U21,0,0,0,0,0,0,0,0
European Under-21 Championship - Group A 2018/19,Spain U21,0,0,0,0,0,0,0,0
European Under-21 Championship - Group B 2018/19,Austria U21,0,0,0,0,0,0,0,0
European Under-21 Championship - Group B 2018/19,Denmark U21,0,0,0,0,0,0,0,0
European Under-21 Championship - Group B 2018/19,Germany U21,0,0,0,0,0,0,0,0
European Under-21 Championship - Group B 2018/19,Serbia U21,0,0,0,0,0,0,0,0
European Under-21 Championship - Group C 2018/19,Croatia U21,0,0,0,0,0,0,0,0
European Under-21 Championship - Group C 2018/19,England U21,0,0,0,0,0,0,0,0
European Under-21 Championship - Group C 2018/19,France U21,0,0,0,0,0,0,0,0
European Under-21 Championship - Group C 2018/19,Romania U21,0,0,0,0,0,0,0,0
European Under-21 Championship - Group A 2019/20,Spain U21,3,2,0,1,8,4,4,6
European Under-21 Championship - Group A 2019/20,Italy U21,3,2,0,1,6,3,3,6
European Under-21 Championship - Group A 2019/20,Poland U21,3,2,0,1,4,7,-3,6
European Under-21 Championship - Group A 2019/20,Belgium U21,3,0,0,3,4,8,-4,0
European Under-21 Championship - Group B 2019/20,Germany U21,3,2,1,0,10,3,7,7
European Under-21 Championship - Group B 2019/20,Denmark U21,3,2,0,1,6,4,2,6
European Under-21 Championship - Group B 2019/20,Austria U21,3,1,1,1,4,4,0,4
European Under-21 Championship - Group B 2019/20,Serbia U21,3,0,0,3,1,10,-9,0
European Under-21 Championship - Group C 2019/20,Romania U21,3,2,1,0,8,3,5,7
European Under-21 Championship - Group C 2019/20,France U21,3,2,1,0,3,1,2,7
European Under-21 Championship - Group C 2019/20,England U21,3,0,1,2,6,9,-3,1
European Under-21 Championship - Group C 2019/20,Croatia U21,3,0,1,2,4,8,-4,1
Women's Premier League Northern Division 2017/18,Blackburn Rovers Ladies,22,18,2,2,68,17,51,56
Women's Premier League Northern Division 2017/18,Leicester City WFC,22,14,4,4,68,32,36,46
Women's Premier League Northern Division 2017/18,Middlesbrough Ladies,22,14,0,8,63,52,11,42
Women's Premier League Northern Division 2017/18,Stoke City Ladies,22,12,4,6,52,38,14,40
Women's Premier League Northern Division 2017/18,Fylde Ladies,22,10,6,6,35,35,0,36
Women's Premier League Northern Division 2017/18,Huddersfield Town Ladies,22,10,5,7,45,27,18,35
Women's Premier League Northern Division 2017/18,Derby County Ladies,22,7,5,10,27,37,-10,26
Women's Premier League Northern Division 2017/18,Bradford City Ladies,22,7,4,11,40,45,-5,25
Women's Premier League Northern Division 2017/18,Nottingham Forest Ladies,22,5,4,13,23,57,-34,19
Women's Premier League Northern Division 2017/18,Guiseley AFC Vixens,22,4,5,13,33,56,-23,17
Women's Premier League Northern Division 2017/18,Wolverhampton Wanderers Ladies,22,4,5,13,30,56,-26,17
Women's Premier League Northern Division 2017/18,West Bromwich Albion WFC,22,4,2,16,27,59,-32,14
Women's Premier League Northern Division 2018/19,Blackburn Rovers Ladies,24,23,0,1,115,18,97,69
Women's Premier League Northern Division 2018/19,Sunderland Ladies,24,15,3,6,83,36,47,48
Women's Premier League Northern Division 2018/19,Derby County Ladies,24,15,3,6,54,35,19,48
Women's Premier League Northern Division 2018/19,Huddersfield Town Ladies,24,15,2,7,79,40,39,47
Women's Premier League Northern Division 2018/19,Middlesbrough Ladies,24,13,4,7,60,41,19,43
Women's Premier League Northern Division 2018/19,Fylde Ladies,24,13,3,8,48,33,15,42
Women's Premier League Northern Division 2018/19,Stoke City Ladies,24,9,6,9,59,51,8,33
Women's Premier League Northern Division 2018/19,Guiseley AFC Vixens,24,9,4,11,45,48,-3,31
Women's Premier League Northern Division 2018/19,Nottingham Forest Ladies,24,7,4,13,29,57,-28,25
Women's Premier League Northern Division 2018/19,Hull City Ladies,24,7,2,15,41,65,-24,23
Women's Premier League Northern Division 2018/19,Sheffield FC Ladies,24,6,3,15,37,55,-18,21
Women's Premier League Northern Division 2018/19,Doncaster Rovers Belles,24,4,6,14,32,75,-43,18
Women's Premier League Northern Division 2018/19,Bradford City Ladies,24,0,0,24,12,140,-128,0
FA Women's National League - Northern Premier Division 2019/20,Sunderland Ladies,14,13,1,0,53,10,43,40
FA Women's National League - Northern Premier Division 2019/20,Derby County Ladies,15,9,2,4,46,17,29,29
FA Women's National League - Northern Premier Division 2019/20,Nottingham Forest Ladies,13,9,1,3,27,19,8,28
FA Women's National League - Northern Premier Division 2019/20,Stoke City Ladies,14,8,1,5,32,17,15,25
FA Women's National League - Northern Premier Division 2019/20,Burnley Ladies,11,7,1,3,19,13,6,22
FA Women's National League - Northern Premier Division 2019/20,Huddersfield Town Ladies,12,5,3,4,35,22,13,18
FA Women's National League - Northern Premier Division 2019/20,West Bromwich Albion WFC,11,5,2,4,31,20,11,17
FA Women's National League - Northern Premier Division 2019/20,Middlesbrough Ladies,15,4,2,9,27,52,-25,14
FA Women's National League - Northern Premier Division 2019/20,Fylde Ladies,14,3,4,7,15,24,-9,13
FA Women's National League - Northern Premier Division 2019/20,Loughborough Foxes WFC,15,4,1,10,24,42,-18,13
FA Women's National League - Northern Premier Division 2019/20,Hull City Ladies,14,2,0,12,23,64,-41,6
FA Women's National League - Northern Premier Division 2019/20,Sheffield FC Ladies,10,1,0,9,7,39,-32,3
FA Women's National League - Northern Premier Division 2020/21,Huddersfield Town Ladies,8,6,1,1,20,12,8,19
FA Women's National League - Northern Premier Division 2020/21,Fylde Ladies,7,5,1,1,21,10,11,16
FA Women's National League - Northern Premier Division 2020/21,Derby County Ladies,8,5,1,2,23,15,8,16
FA Women's National League - Northern Premier Division 2020/21,Nottingham Forest Ladies,8,4,2,2,21,10,11,14
FA Women's National League - Northern Premier Division 2020/21,West Bromwich Albion WFC,8,4,1,3,22,13,9,13
FA Women's National League - Northern Premier Division 2020/21,Sunderland Ladies,8,4,0,4,12,13,-1,12
FA Women's National League - Northern Premier Division 2020/21,Stoke City Ladies,7,3,2,2,14,14,0,11
FA Women's National League - Northern Premier Division 2020/21,Burnley Ladies,7,3,1,3,11,11,0,10
FA Women's National League - Northern Premier Division 2020/21,Middlesbrough Ladies,8,2,1,5,13,21,-8,7
FA Women's National League - Northern Premier Division 2020/21,Hull City Ladies,6,1,2,3,8,14,-6,5
FA Women's National League - Northern Premier Division 2020/21,Sheffield FC Ladies,7,1,0,6,7,20,-13,3
FA Women's National League - Northern Premier Division 2020/21,Loughborough Foxes WFC,8,0,2,6,8,27,-19,2
Women's Premier League Southern Division 2017/18,Charlton Athletic Women,22,20,0,2,98,13,85,60
Women's Premier League Southern Division 2017/18,C&K Basildon Ladies,22,17,1,4,51,24,27,52
Women's Premier League Southern Division 2017/18,Crystal Palace Women,22,16,2,4,59,15,44,50
Women's Premier League Southern Division 2017/18,Coventry United Ladies,22,14,2,6,69,20,49,44
Women's Premier League Southern Division 2017/18,Lewes Women,22,14,2,6,45,25,20,44
Women's Premier League Southern Division 2017/18,Portsmouth Ladies,22,12,1,9,44,35,9,37
Women's Premier League Southern Division 2017/18,West Ham United Women,22,9,2,11,57,42,15,29
Women's Premier League Southern Division 2017/18,Chichester City Ladies,22,8,4,10,43,48,-5,28
Women's Premier League Southern Division 2017/18,Gillingham Ladies,22,5,2,15,24,53,-29,17
Women's Premier League Southern Division 2017/18,Cardiff City Ladies,22,4,4,14,40,69,-29,16
Women's Premier League Southern Division 2017/18,Hounslow Women,22,2,2,18,17,94,-77,8
Women's Premier League Southern Division 2017/18,Swindon Town Ladies,22,0,0,22,10,119,-109,0
Women's Premier League Southern Division 2018/19,Coventry United Ladies,22,18,3,1,80,14,66,57
Women's Premier League Southern Division 2018/19,Cardiff City Ladies,22,16,2,4,58,26,32,50
Women's Premier League Southern Division 2018/19,Chichester City Ladies,22,15,1,6,48,27,21,46
Women's Premier League Southern Division 2018/19,Oxford United Women,22,13,2,7,56,24,32,41
Women's Premier League Southern Division 2018/19,Watford Ladies,22,13,1,8,43,40,3,40
Women's Premier League Southern Division 2018/19,Plymouth Argyle Ladies,22,11,2,9,50,54,-4,35
Women's Premier League Southern Division 2018/19,Loughborough Foxes WFC,22,10,4,8,48,32,16,34
Women's Premier League Southern Division 2018/19,Portsmouth Ladies,22,9,1,12,41,38,3,28
Women's Premier League Southern Division 2018/19,MK Dons Ladies,22,6,1,15,28,52,-24,19
Women's Premier League Southern Division 2018/19,Gillingham Ladies,22,5,4,13,24,54,-30,19
Women's Premier League Southern Division 2018/19,Hounslow Women,22,2,5,15,28,69,-41,11
Women's Premier League Southern Division 2018/19,C&K Basildon Ladies,22,0,2,20,17,91,-74,2
FA Women's National League - Southern Premier Division 2019/20,Crawley Wasps Ladies,14,12,1,1,36,9,27,37
FA Women's National League - Southern Premier Division 2019/20,Watford Ladies,11,9,1,1,40,14,26,28
FA Women's National League - Southern Premier Division 2019/20,Oxford United Women,14,9,0,5,44,20,24,27
FA Women's National League - Southern Premier Division 2019/20,Plymouth Argyle Ladies,14,9,0,5,42,18,24,27
FA Women's National League - Southern Premier Division 2019/20,Yeovil Town Ladies,13,8,2,3,46,17,29,26
FA Women's National League - Southern Premier Division 2019/20,Cardiff City Ladies,13,8,1,4,23,9,14,25
FA Women's National League - Southern Premier Division 2019/20,Portsmouth Ladies,9,5,0,4,28,15,13,15
FA Women's National League - Southern Premier Division 2019/20,MK Dons Ladies,14,4,1,9,18,30,-12,13
FA Women's National League - Southern Premier Division 2019/20,Gillingham Ladies,11,3,2,6,12,27,-15,11
FA Women's National League - Southern Premier Division 2019/20,Keynsham Town Ladies,12,2,1,9,9,39,-30,7
FA Women's National League - Southern Premier Division 2019/20,Hounslow Women,14,0,3,11,4,73,-69,3
FA Women's National League - Southern Premier Division 2019/20,Chichester City Ladies,13,0,2,11,6,37,-31,2
FA Women's National League - Southern Premier Division 2020/21,Watford Ladies,7,5,1,1,24,6,18,16
FA Women's National League - Southern Premier Division 2020/21,MK Dons Ladies,7,5,0,2,22,7,15,15
FA Women's National League - Southern Premier Division 2020/21,Oxford United Women,6,5,0,1,19,5,14,15
FA Women's National League - Southern Premier Division 2020/21,Portsmouth Ladies,7,4,1,2,17,7,10,13
FA Women's National League - Southern Premier Division 2020/21,Crawley Wasps Ladies,6,4,0,2,10,5,5,12
FA Women's National League - Southern Premier Division 2020/21,Chichester City Ladies,5,3,0,2,14,6,8,9
FA Women's National League - Southern Premier Division 2020/21,Yeovil Town Ladies,5,2,2,1,9,8,1,8
FA Women's National League - Southern Premier Division 2020/21,Cardiff City Ladies,3,2,0,1,11,6,5,6
FA Women's National League - Southern Premier Division 2020/21,Keynsham Town Ladies,6,2,0,4,12,12,0,6
FA Women's National League - Southern Premier Division 2020/21,Gillingham Ladies,7,2,0,5,10,14,-4,6
FA Women's National League - Southern Premier Division 2020/21,Plymouth Argyle Ladies,6,0,0,6,2,38,-36,0
FA Women's National League - Southern Premier Division 2020/21,Hounslow Women,7,0,0,7,0,36,-36,0
FA Women's Championship 2018/19,Manchester United Women,20,18,1,1,98,7,91,55
FA Women's Championship 2018/19,Tottenham Hotspur Women,20,15,1,4,44,27,17,46
FA Women's Championship 2018/19,Charlton Athletic Women,20,13,2,5,49,21,28,41
FA Women's Championship 2018/19,Durham Women,20,11,6,3,37,16,21,39
FA Women's Championship 2018/19,Sheffield United Women,20,11,1,8,35,31,4,34
FA Women's Championship 2018/19,Aston Villa Ladies,20,6,8,6,30,39,-9,26
FA Women's Championship 2018/19,Leicester City Women,20,6,3,11,27,44,-17,21
FA Women's Championship 2018/19,London Bees,20,7,0,13,23,48,-25,21
FA Women's Championship 2018/19,Lewes Women,20,5,2,13,23,47,-24,17
FA Women's Championship 2018/19,Crystal Palace Women,20,3,2,15,14,44,-30,11
FA Women's Championship 2018/19,London City Lionesses,20,1,2,17,14,70,-56,5
FA Women's Championship 2019/20,Aston Villa Ladies,14,13,1,0,39,11,28,40
FA Women's Championship 2019/20,Sheffield United Women,14,11,1,2,46,16,30,34
FA Women's Championship 2019/20,Durham Women,14,10,2,2,33,10,23,32
FA Women's Championship 2019/20,London City Lionesses,15,8,2,5,25,24,1,26
FA Women's Championship 2019/20,London Bees,12,4,3,5,16,19,-3,15
FA Women's Championship 2019/20,Leicester City Women,15,4,3,8,22,35,-13,15
FA Women's Championship 2019/20,Blackburn Rovers Ladies,12,3,1,8,13,25,-12,10
FA Women's Championship 2019/20,Lewes Women,12,2,3,7,10,18,-8,9
FA Women's Championship 2019/20,Crystal Palace Women,14,2,4,8,15,33,-18,10
FA Women's Championship 2019/20,Coventry United Ladies,14,2,3,9,19,35,-16,9
FA Women's Championship 2019/20,Charlton Athletic Women,12,0,7,5,9,21,-12,7
FA Women's Championship 2020/21,Sheffield United Women,6,4,2,0,16,3,13,14
FA Women's Championship 2020/21,Durham Women,6,4,2,0,11,4,7,14
FA Women's Championship 2020/21,Liverpool Women,6,3,2,1,13,6,7,11
FA Women's Championship 2020/21,Leicester City Women,6,3,2,1,14,10,4,11
FA Women's Championship 2020/21,Lewes Women,6,3,2,1,5,5,0,11
FA Women's Championship 2020/21,London City Lionesses,7,2,1,4,8,10,-2,7
FA Women's Championship 2020/21,Coventry United Ladies,5,2,0,3,7,9,-2,6
FA Women's Championship 2020/21,Blackburn Rovers Ladies,5,2,0,3,4,7,-3,6
FA Women's Championship 2020/21,Crystal Palace Women,7,1,2,4,10,16,-6,5
FA Women's Championship 2020/21,Charlton Athletic Women,5,1,1,3,5,10,-5,4
FA Women's Championship 2020/21,London Bees,7,1,0,6,5,18,-13,3
FA Women's Super League 2010/11,Birmingham Ladies,7,5,2,0,14,2,12,17
FA Women's Super League 2010/11,Arsenal Women,6,4,1,1,10,4,6,13
FA Women's Super League 2010/11,Chelsea Women,7,3,3,1,9,5,4,12
FA Women's Super League 2010/11,Everton Women,6,1,4,1,5,6,-1,7
FA Women's Super League 2010/11,Bristol Academy,7,1,4,2,4,8,-4,7
FA Women's Super League 2010/11,Doncaster Rovers Belles,7,2,1,4,4,10,-6,7
FA Women's Super League 2010/11,Notts County Ladies,7,1,2,4,2,6,-4,5
FA Women's Super League 2010/11,Liverpool Women,7,0,3,4,5,12,-7,3
FA Women's Super League 2011/12,Arsenal Women,14,10,2,2,29,9,20,32
FA Women's Super League 2011/12,Birmingham Ladies,14,8,5,1,29,13,16,29
FA Women's Super League 2011/12,Everton Women,14,7,4,3,19,13,6,25
FA Women's Super League 2011/12,Notts County Ladies,14,6,3,5,18,16,2,21
FA Women's Super League 2011/12,Bristol Academy,14,4,4,6,14,20,-6,16
FA Women's Super League 2011/12,Chelsea Women,14,4,3,7,14,19,-5,15
FA Women's Super League 2011/12,Doncaster Rovers Belles,14,2,3,9,9,26,-17,9
FA Women's Super League 2011/12,Liverpool Women,14,1,4,9,10,26,-16,7
FA Women's Super League 2012/13,Arsenal Women,14,10,4,0,39,18,21,34
FA Women's Super League 2012/13,Birmingham Ladies,14,7,5,2,31,18,13,26
FA Women's Super League 2012/13,Everton Women,14,7,4,3,20,16,4,25
FA Women's Super League 2012/13,Bristol Academy,14,4,6,4,17,16,1,18
FA Women's Super League 2012/13,Notts County Ladies,14,5,3,6,24,26,-2,18
FA Women's Super League 2012/13,Chelsea Women,14,5,2,7,20,23,-3,17
FA Women's Super League 2012/13,Doncaster Rovers Belles,14,3,2,9,14,28,-14,11
FA Women's Super League 2012/13,Liverpool Women,14,1,2,11,15,35,-20,5
FA Women's Super League 2013/14,Liverpool Women,14,12,0,2,46,19,27,36
FA Women's Super League 2013/14,Bristol Academy,14,10,1,3,30,20,10,31
FA Women's Super League 2013/14,Arsenal Women *,14,10,3,1,31,11,20,30
FA Women's Super League 2013/14,Birmingham Ladies,14,5,3,6,16,21,-5,18
FA Women's Super League 2013/14,Everton Women,14,4,3,7,23,30,-7,15
FA Women's Super League 2013/14,Notts County Ladies,14,2,4,8,10,15,-5,10
FA Women's Super League 2013/14,Chelsea Women,14,3,1,10,20,27,-7,10
FA Women's Super League 2013/14,Doncaster Rovers Belles,14,1,3,10,9,42,-33,6
FA Women's Super League 2014/15,Chelsea Women,13,8,2,3,22,14,8,26
FA Women's Super League 2014/15,Birmingham Ladies,13,7,3,3,18,12,6,24
FA Women's Super League 2014/15,Liverpool Women,13,6,5,2,16,10,6,23
FA Women's Super League 2014/15,Arsenal Women,13,5,3,5,21,20,1,18
FA Women's Super League 2014/15,Notts County Ladies,12,4,5,3,10,6,4,17
FA Women's Super League 2014/15,Man City Women,13,5,1,7,11,15,-4,16
FA Women's Super League 2014/15,Bristol Academy,12,4,1,7,18,21,-3,13
FA Women's Super League 2014/15,Everton Women,13,0,4,9,9,27,-18,4
FA Women's Super League 2015/16,Chelsea Women,14,10,2,2,30,10,20,32
FA Women's Super League 2015/16,Manchester City Women,14,9,3,2,25,11,14,30
FA Women's Super League 2015/16,Arsenal Women,14,8,3,3,21,13,8,27
FA Women's Super League 2015/16,Sunderland Ladies,14,6,2,6,24,24,0,20
FA Women's Super League 2015/16,Notts County Ladies,14,4,3,7,20,20,0,15
FA Women's Super League 2015/16,Birmingham City Women,14,3,4,7,7,14,-7,13
FA Women's Super League 2015/16,Liverpool Women,14,4,1,9,15,24,-9,13
FA Women's Super League 2015/16,Bristol City Women,14,2,2,10,12,38,-26,8
FA Women's Super League 2016/17,Manchester City Women,16,13,3,0,36,4,32,42
FA Women's Super League 2016/17,Chelsea Women,16,12,1,3,42,17,25,37
FA Women's Super League 2016/17,Arsenal Women,16,10,2,4,33,14,19,32
FA Women's Super League 2016/17,Birmingham City Women,16,7,6,3,18,13,5,27
FA Women's Super League 2016/17,Liverpool Women,16,7,4,5,27,23,4,25
FA Women's Super League 2016/17,Notts County Ladies,16,4,4,8,16,26,-10,16
FA Women's Super League 2016/17,Sunderland Ladies,16,2,4,10,17,41,-24,10
FA Women's Super League 2016/17,Reading Women,16,1,6,9,15,26,-11,9
FA Women's Super League 2016/17,Doncaster Rovers Belles,16,1,0,15,8,48,-40,3
FA Women's Super League 2017/18,Chelsea Women,18,13,5,0,44,13,31,44
FA Women's Super League 2017/18,Manchester City Women,18,12,2,4,51,17,34,38
FA Women's Super League 2017/18,Arsenal Women,18,11,4,3,38,18,20,37
FA Women's Super League 2017/18,Reading Women,18,9,5,4,40,18,22,32
FA Women's Super League 2017/18,Birmingham City Women,18,9,3,6,30,18,12,30
FA Women's Super League 2017/18,Liverpool Women,18,9,1,8,30,27,3,28
FA Women's Super League 2017/18,Sunderland Ladies,18,5,1,12,15,40,-25,16
FA Women's Super League 2017/18,Bristol City Women,18,5,1,12,13,47,-34,16
FA Women's Super League 2017/18,Everton Women,18,4,2,12,19,30,-11,14
FA Women's Super League 2017/18,Yeovil Town Ladies,18,0,2,16,2,54,-52,2
FA Women's Super League 2018/19,Arsenal Women,20,18,0,2,70,13,57,54
FA Women's Super League 2018/19,Manchester City Women,20,14,5,1,53,17,36,47
FA Women's Super League 2018/19,Chelsea Women,20,12,6,2,46,14,32,42
FA Women's Super League 2018/19,Birmingham City Women,20,13,1,6,29,17,12,40
FA Women's Super League 2018/19,Reading Women,20,8,3,9,33,30,3,27
FA Women's Super League 2018/19,Bristol City Women,20,7,4,9,17,34,-17,25
FA Women's Super League 2018/19,West Ham United Women,20,7,2,11,25,37,-12,23
FA Women's Super League 2018/19,Liverpool Women,20,7,1,12,21,38,-17,22
FA Women's Super League 2018/19,Brighton and Hove Albion Women,20,4,4,12,16,38,-22,16
FA Women's Super League 2018/19,Everton Women,20,3,3,14,15,38,-23,12
FA Women's Super League 2018/19,Yeovil Town Ladies,20,2,1,17,11,60,-49,-3
FA Women's Super League 2019/20,Chelsea Women,15,12,3,0,47,11,36,39
FA Women's Super League 2019/20,Manchester City Women,16,13,1,2,39,9,30,40
FA Women's Super League 2019/20,Arsenal Women,15,12,0,3,40,13,27,36
FA Women's Super League 2019/20,Manchester United Women,14,7,2,5,24,12,12,23
FA Women's Super League 2019/20,Reading Women,14,6,3,5,21,24,-3,21
FA Women's Super League 2019/20,Everton Women,14,6,1,7,21,21,0,19
FA Women's Super League 2019/20,Tottenham Hotspur Women,15,6,2,7,15,24,-9,20
FA Women's Super League 2019/20,West Ham United Women,14,5,1,8,19,34,-15,16
FA Women's Super League 2019/20,Brighton and Hove Albion Women,16,3,4,9,11,30,-19,13
FA Women's Super League 2019/20,Bristol City Women,14,2,3,9,9,38,-29,9
FA Women's Super League 2019/20,Birmingham City Women,13,2,1,10,5,23,-18,7
FA Women's Super League 2019/20,Liverpool Women,14,1,3,10,8,20,-12,6
FA Women's Super League 2020/21,Arsenal Women,5,5,0,0,29,4,25,15
FA Women's Super League 2020/21,Everton Women,5,4,1,0,16,3,13,13
FA Women's Super League 2020/21,Manchester United Women,5,4,1,0,14,5,9,13
FA Women's Super League 2020/21,Chelsea Women,4,3,1,0,14,2,12,10
FA Women's Super League 2020/21,Manchester City Women,5,2,2,1,8,5,3,8
FA Women's Super League 2020/21,Reading Women,5,2,1,2,6,9,-3,7
FA Women's Super League 2020/21,Birmingham City Women,5,2,0,3,7,8,-1,6
FA Women's Super League 2020/21,Brighton and Hove Albion Women,5,1,2,2,4,10,-6,5
FA Women's Super League 2020/21,Tottenham Hotspur Women,5,0,1,4,3,13,-10,1
FA Women's Super League 2020/21,West Ham United Women,5,0,1,4,5,18,-13,1
FA Women's Super League 2020/21,Aston Villa Ladies,3,0,0,3,1,11,-10,0
FA Women's Super League 2020/21,Bristol City Women,4,0,0,4,1,20,-19,0
FIFA Women's World Cup - Group A 2014/15,Canada Women,2,1,1,0,1,0,1,4
FIFA Women's World Cup - Group A 2014/15,China Women,2,1,0,1,1,1,0,3
FIFA Women's World Cup - Group A 2014/15,Holland Women,2,1,0,1,1,1,0,3
FIFA Women's World Cup - Group A 2014/15,New Zealand Women,2,0,1,1,0,1,-1,1
FIFA Women's World Cup - Group B 2014/15,Germany Women,2,1,1,0,11,1,10,4
FIFA Women's World Cup - Group B 2014/15,Norway Women,2,1,1,0,5,1,4,4
FIFA Women's World Cup - Group B 2014/15,Thailand Women,2,1,0,1,3,6,-3,3
FIFA Women's World Cup - Group B 2014/15,Côte d'Ivoire Women,2,0,0,2,2,13,-11,0
FIFA Women's World Cup - Group C 2014/15,Japan Women,2,2,0,0,3,1,2,6
FIFA Women's World Cup - Group C 2014/15,Switzerland Women,2,1,0,1,10,2,8,3
FIFA Women's World Cup - Group C 2014/15,Cameroon Women,2,1,0,1,7,2,5,3
FIFA Women's World Cup - Group C 2014/15,Ecuador Women,2,0,0,2,1,16,-15,0
FIFA Women's World Cup - Group D 2014/15,USA Women,2,1,1,0,3,1,2,4
FIFA Women's World Cup - Group D 2014/15,Australia Women,2,1,0,1,3,3,0,3
FIFA Women's World Cup - Group D 2014/15,Sweden Women,2,0,2,0,3,3,0,2
FIFA Women's World Cup - Group D 2014/15,Nigeria Women,2,0,1,1,3,5,-2,1
FIFA Women's World Cup - Group E 2014/15,Brazil Women,2,2,0,0,3,0,3,6
FIFA Women's World Cup - Group E 2014/15,Costa Rica Women,2,0,2,0,3,3,0,2
FIFA Women's World Cup - Group E 2014/15,Spain Women,2,0,1,1,1,2,-1,1
FIFA Women's World Cup - Group E 2014/15,Korea Republic Women,2,0,1,1,2,4,-2,1
FIFA Women's World Cup - Group F 2014/15,Colombia Women,2,1,1,0,3,1,2,4
FIFA Women's World Cup - Group F 2014/15,England Women,2,1,0,1,2,2,0,3
FIFA Women's World Cup - Group F 2014/15,France Women,2,1,0,1,1,2,-1,3
FIFA Women's World Cup - Group F 2014/15,Mexico Women,2,0,1,1,2,3,-1,1
FIFA Women's World Cup - Group A 2015/16,Canada Women,3,1,2,0,2,1,1,5
FIFA Women's World Cup - Group A 2015/16,China Women,3,1,1,1,3,3,0,4
FIFA Women's World Cup - Group A 2015/16,Holland Women,3,1,1,1,2,2,0,4
FIFA Women's World Cup - Group A 2015/16,New Zealand Women,3,0,2,1,2,3,-1,2
FIFA Women's World Cup - Group B 2015/16,Germany Women,3,2,1,0,15,1,14,7
FIFA Women's World Cup - Group B 2015/16,Norway Women,3,2,1,0,8,2,6,7
FIFA Women's World Cup - Group B 2015/16,Thailand Women,3,1,0,2,3,10,-7,3
FIFA Women's World Cup - Group B 2015/16,Côte d'Ivoire Women,3,0,0,3,3,16,-13,0
FIFA Women's World Cup - Group C 2015/16,Japan Women,3,3,0,0,4,1,3,9
FIFA Women's World Cup - Group C 2015/16,Cameroon Women,3,2,0,1,9,3,6,6
FIFA Women's World Cup - Group C 2015/16,Switzerland Women,3,1,0,2,11,4,7,3
FIFA Women's World Cup - Group C 2015/16,Ecuador Women,3,0,0,3,1,17,-16,0
FIFA Women's World Cup - Group D 2015/16,USA Women,3,2,1,0,4,1,3,7
FIFA Women's World Cup - Group D 2015/16,Australia Women,3,1,1,1,4,4,0,4
FIFA Women's World Cup - Group D 2015/16,Sweden Women,3,0,3,0,4,4,0,3
FIFA Women's World Cup - Group D 2015/16,Nigeria Women,3,0,1,2,3,6,-3,1
FIFA Women's World Cup - Group E 2015/16,Brazil Women,3,3,0,0,4,0,4,9
FIFA Women's World Cup - Group E 2015/16,Korea Republic Women,3,1,1,1,4,5,-1,4
FIFA Women's World Cup - Group E 2015/16,Costa Rica Women,3,0,2,1,3,4,-1,2
FIFA Women's World Cup - Group E 2015/16,Spain Women,3,0,1,2,2,4,-2,1
FIFA Women's World Cup - Group F 2015/16,France Women,3,2,0,1,6,2,4,6
FIFA Women's World Cup - Group F 2015/16,England Women,3,2,0,1,4,3,1,6
FIFA Women's World Cup - Group F 2015/16,Colombia Women,3,1,1,1,4,3,1,4
FIFA Women's World Cup - Group F 2015/16,Mexico Women,3,0,1,2,2,8,-6,1
FIFA Women's World Cup - Group A 2018/19,France Women,0,0,0,0,0,0,0,0
FIFA Women's World Cup - Group A 2018/19,Korea Republic Women,0,0,0,0,0,0,0,0
FIFA Women's World Cup - Group A 2018/19,Nigeria Women,0,0,0,0,0,0,0,0
FIFA Women's World Cup - Group A 2018/19,Norway Women,0,0,0,0,0,0,0,0
FIFA Women's World Cup - Group B 2018/19,China Women,0,0,0,0,0,0,0,0
FIFA Women's World Cup - Group B 2018/19,Germany Women,0,0,0,0,0,0,0,0
FIFA Women's World Cup - Group B 2018/19,South Africa Women,0,0,0,0,0,0,0,0
FIFA Women's World Cup - Group B 2018/19,Spain Women,0,0,0,0,0,0,0,0
FIFA Women's World Cup - Group C 2018/19,Australia Women,0,0,0,0,0,0,0,0
FIFA Women's World Cup - Group C 2018/19,Brazil Women,0,0,0,0,0,0,0,0
FIFA Women's World Cup - Group C 2018/19,Italy Ladies,0,0,0,0,0,0,0,0
FIFA Women's World Cup - Group C 2018/19,Jamaica Women,0,0,0,0,0,0,0,0
FIFA Women's World Cup - Group D 2018/19,Argentina Women,0,0,0,0,0,0,0,0
FIFA Women's World Cup - Group D 2018/19,England Women,0,0,0,0,0,0,0,0
FIFA Women's World Cup - Group D 2018/19,Japan Women,0,0,0,0,0,0,0,0
FIFA Women's World Cup - Group D 2018/19,Scotland Women,0,0,0,0,0,0,0,0
FIFA Women's World Cup - Group E 2018/19,Cameroon Women,0,0,0,0,0,0,0,0
FIFA Women's World Cup - Group E 2018/19,Canada Women,0,0,0,0,0,0,0,0
FIFA Women's World Cup - Group E 2018/19,Holland Women,0,0,0,0,0,0,0,0
FIFA Women's World Cup - Group E 2018/19,New Zealand Women,0,0,0,0,0,0,0,0
FIFA Women's World Cup - Group F 2018/19,Chile Women,0,0,0,0,0,0,0,0
FIFA Women's World Cup - Group F 2018/19,Sweden Women,0,0,0,0,0,0,0,0
FIFA Women's World Cup - Group F 2018/19,Thailand Women,0,0,0,0,0,0,0,0
FIFA Women's World Cup - Group F 2018/19,USA Women,0,0,0,0,0,0,0,0
FIFA Women's World Cup - Group A 2019/20,France Women,3,3,0,0,7,1,6,9
FIFA Women's World Cup - Group A 2019/20,Norway Women,3,2,0,1,6,3,3,6
FIFA Women's World Cup - Group A 2019/20,Nigeria Women,3,1,0,2,2,4,-2,3
FIFA Women's World Cup - Group A 2019/20,Korea Republic Women,3,0,0,3,1,8,-7,0
FIFA Women's World Cup - Group B 2019/20,Germany Women,3,3,0,0,6,0,6,9
FIFA Women's World Cup - Group B 2019/20,Spain Women,3,1,1,1,3,2,1,4
FIFA Women's World Cup - Group B 2019/20,China Women,3,1,1,1,1,1,0,4
FIFA Women's World Cup - Group B 2019/20,South Africa Women,3,0,0,3,1,8,-7,0
FIFA Women's World Cup - Group C 2019/20,Italy Ladies,3,2,0,1,7,2,5,6
FIFA Women's World Cup - Group C 2019/20,Australia Women,3,2,0,1,8,5,3,6
FIFA Women's World Cup - Group C 2019/20,Brazil Women,3,2,0,1,6,3,3,6
FIFA Women's World Cup - Group C 2019/20,Jamaica Women,3,0,0,3,1,12,-11,0
FIFA Women's World Cup - Group D 2019/20,England Women,3,3,0,0,5,1,4,9
FIFA Women's World Cup - Group D 2019/20,Japan Women,3,1,1,1,2,3,-1,4
FIFA Women's World Cup - Group D 2019/20,Argentina Women,3,0,2,1,3,4,-1,2
FIFA Women's World Cup - Group D 2019/20,Scotland Women,3,0,1,2,5,7,-2,1
FIFA Women's World Cup - Group E 2019/20,Holland Women,3,3,0,0,6,2,4,9
FIFA Women's World Cup - Group E 2019/20,Canada Women,3,2,0,1,4,2,2,6
FIFA Women's World Cup - Group E 2019/20,Cameroon Women,3,1,0,2,3,5,-2,3
FIFA Women's World Cup - Group E 2019/20,New Zealand Women,3,0,0,3,1,5,-4,0
FIFA Women's World Cup - Group F 2019/20,USA Women,3,3,0,0,18,0,18,9
FIFA Women's World Cup - Group F 2019/20,Sweden Women,3,2,0,1,7,3,4,6
FIFA Women's World Cup - Group F 2019/20,Chile Women,3,1,0,2,2,5,-3,3
FIFA Women's World Cup - Group F 2019/20,Thailand Women,3,0,0,3,1,20,-19,0
